Address,Gen1Total,Gen2Total,totalBalance,series1Balance,series2Balance,Bonus,BonusNFTs
0xb104c36540604bc406a4d8510b1b82d30b5cdb78,"[0, 1]","[44, 47, 48, 45, 46, 1090, 1091, 1092, 1093, 1094, 1734]",13,2,11,2,"[0, 1]"
0xef7d145e7921013997a7718f7c5b047a6f5c3612,[3],[1324],2,1,1,1,[3]
0x1eb39d46c9814c8f16ea657d9dc1029575f4d651,"[7, 8, 9, 5, 6]",,5,5,0,0,[]
0x6fbca530761e132b11b0e3a9e4fc744d2a371c8e,[10],"[18, 943, 944, 945, 946]",6,1,5,1,[10]
0x3ae5edbdd1342ce6acaa48342792315d52e7b067,[11],[219],2,1,1,1,[11]
0x836aa4cea7e7ff99f4f45a8be38eabaff897176f,[12],,1,1,0,0,[]
0x003f462db7b98c41634db07edc60b2dc7f9acb67,[13],,1,1,0,0,[]
0xe475b4ae7f4c549817768537c0f8ae8bd4def540,"[14, 15, 16, 17, 18, 19, 20, 21, 22, 23]","[2066, 2067, 2068, 2069, 2070, 2071, 1624, 1173]",18,10,8,8,"[14, 15, 16, 17, 18, 19, 20, 21]"
0x823a4b282f6c8c78fbf2c63860e777c395e5f213,"[30, 31, 32, 33, 1629]","[1174, 1622, 1623, 2064, 2063]",10,5,5,5,"[30, 31, 32, 33, 1629]"
0x7d3259654436ad5c70881fdb3bf53853b50cb51f,[34],[28],2,1,1,1,[34]
0x90598faecb13b32b33e0d2ad07e74eace9afd64f,"[35, 36, 37, 38]",,4,4,0,0,[]
0x6416ad25d5679f61395585bd68551624bef9a755,[39],,1,1,0,0,[]
0x69e8e7228dc1205fa424999aa4ff2389c088adff,"[40, 41]",,2,2,0,0,[]
0xcb8044289f0af12d84f994cf5dda018368fcd098,[42],[1006],2,1,1,1,[42]
0xf7bbbd48a1bc26c613ad3fba0ea39e748fe0592b,"[45, 46]","[201, 1242, 1243, 1244]",6,2,4,2,"[45, 46]"
0xca64f8bffb5351a22b0e171d99eadc6612ba0ec9,"[54, 897, 301, 619, 200, 448, 123, 55, 1823, 609, 29, 1816, 984, 564]","[2160, 2161, 2162, 2163, 2164, 2165, 2166, 2167, 3014, 3015, 3016, 3017, 3018, 3019, 3020, 1785, 2964, 904, 118, 119, 135, 134, 493, 1544, 2151, 2152, 2153]",41,14,27,14,"[54, 897, 301, 619, 200, 448, 123, 55, 1823, 609, 29, 1816, 984, 564]"
0x2fce053e055c432107a2fd98a355c75b406b5bba,[57],,1,1,0,0,[]
0x2c6602c1200f08eb57cc06eada1c215cfd7d0b7c,[58],"[648, 647, 646]",4,1,3,1,[58]
0x61ee78d46064dd175220c54281cea53fa6c13492,[59],,1,1,0,0,[]
0xdd071d33bfcf21286ac874c9617a9b350b3072c1,"[74, 75, 76, 77, 78, 79, 80, 81, 82, 83, 84, 85, 86, 87, 88, 89, 90, 91, 92, 93, 94, 95, 96, 97, 98, 99, 116, 117, 118, 119, 120, 121, 109, 108, 113, 112, 111, 110, 107, 100, 105, 104, 103, 102, 101]",,45,45,0,0,[]
0x2cf5029623ea5f00403591f4b513c3cd8ce33cab,"[132, 131, 130]","[1458, 1459, 1460, 1461, 1462, 1463, 1466, 1467]",11,3,8,3,"[132, 131, 130]"
0xf47e3493991b05be2ed554cce0442fd1fb2a6436,"[137, 138, 139, 140, 141]","[1743, 1744, 1745, 1746, 1747]",10,5,5,5,"[137, 138, 139, 140, 141]"
0xf87f1d62c82776ff01ba359422804309e95fbf5b,[143],,1,1,0,0,[]
0x8922aa8921de71e66824b0665e7fbe0488a0fcca,"[144, 145, 146]","[136, 916, 917]",6,3,3,3,"[144, 145, 146]"
0xaf2cc2741afa212be9fe80a3b853e3fe48cb4ea2,"[147, 148]","[1258, 1259]",4,2,2,2,"[147, 148]"
0xb7767355aa657b3ed66f0de24da5018a5e2862bd,[151],"[1425, 2707, 2708, 2709, 2710]",6,1,5,1,[151]
0x80b9a849a18aa403bfa8d2b28d016c02aea65090,"[154, 155, 156, 157, 158, 159]",,6,6,0,0,[]
0xde9a65d3f549edd70163795479a7c88d13dbb15c,"[162, 163, 164, 165, 166]","[1426, 1427]",7,5,2,2,"[162, 163]"
0xf2151bf89ed2d385568559983ece5fd7770f7427,"[150, 149]","[1847, 1848, 1849, 1850, 1851]",7,2,5,2,"[150, 149]"
0x02a22fc3f3403e80067c1ac07561b10c56e6e171,[168],,1,1,0,0,[]
0xbcb13e595cfe2c06024d4157e9d290bcbb6cf739,"[170, 169]","[1604, 1605, 1606, 2497, 2498, 2499, 2500, 2501]",10,2,8,2,"[170, 169]"
0xa645a9402a25d330beb716cc50bc71e91a47f73a,[172],[3183],2,1,1,1,[172]
0xae77f2a6d9e52db6a9761f13200093868ae06255,"[173, 174, 175, 176, 177, 178, 179, 180, 181, 182, 183, 184, 185, 186, 187, 188, 189, 190, 191, 192, 193, 194, 195, 196, 197]","[2081, 2082, 2083, 2084, 2085, 2086, 2087, 2088, 2089, 2090, 2091, 2092, 2093, 2094, 2095, 2096, 2097, 2098, 2099, 2100, 2101, 2102, 2103, 2104, 2105, 2106]",51,25,26,25,"[173, 174, 175, 176, 177, 178, 179, 180, 181, 182, 183, 184, 185, 186, 187, 188, 189, 190, 191, 192, 193, 194, 195, 196, 197]"
0x863a8faa3ed7df945ddcc03b5b6074f8e56c3fbb,[201],"[831, 832, 833, 834, 835]",6,1,5,1,[201]
0x7237b3abbbc636510adcd24747d090fc6db407d4,"[202, 203, 204]",,3,3,0,0,[]
0x04c934a77aacc7789d2caa8001ed15d2ab66ea97,[205],,1,1,0,0,[]
0x5795f232dcb4f633de047965add229c732794aeb,"[206, 1420, 1471, 340, 1422, 295, 278]","[2759, 2760, 2761, 2762, 1418, 632, 1670]",14,7,7,7,"[206, 1420, 1471, 340, 1422, 295, 278]"
0x6916c90a62611524f893726e7f70417b08dd2c31,[214],,1,1,0,0,[]
0x404f21bf70b3f9181c559365902a2d1cf26f8b94,"[222, 223, 224, 225]","[229, 230, 231, 232, 233, 234, 235, 236, 244, 238, 239, 1049, 1050]",17,4,13,4,"[222, 223, 224, 225]"
0x81dc6f15ee72f6e6d49cb6ca44c0bf8e63770027,"[226, 227, 228, 229, 230, 231, 232, 233, 234, 235]","[1201, 1202, 1203, 1204, 1205, 1206, 1207, 1208, 1209, 1210, 1211, 1212, 1213, 1214, 1215, 1216, 1217, 1218, 1219, 1220]",30,10,20,10,"[226, 227, 228, 229, 230, 231, 232, 233, 234, 235]"
0x13c5f79fe6fa9c4923ff4a81fce4e8cc8bb22314,[236],"[547, 548]",3,1,2,1,[236]
0x096e49f877394fe0191ceccda7ecb6f3fc92cf98,[237],,1,1,0,0,[]
0x2364797fda4928016e631adf65e532a941c86afd,[238],,1,1,0,0,[]
0x0968000a069972d61504aacb06c59ff54e977979,[240],,1,1,0,0,[]
0x24c6bbb049784095b398f54b963cc5c9189436e3,[242],,1,1,0,0,[]
0xe9e903f1ca716fb5e315b1729c0d06c0ce5f357a,"[243, 244]",,2,2,0,0,[]
0x9b94703b2a838400e77767ded579f365fe439c5c,[246],"[1438, 1439]",3,1,2,1,[246]
0xb48332105aa1eff2e2b6b11639ac441c4b903295,"[247, 248]",,2,2,0,0,[]
0xe570f9bf7ece5a8b86289588c077dc69cac7111a,[249],[1494],2,1,1,1,[249]
0x470f0ee2449484f55b1eb3a7b736cb0d4e377202,[250],,1,1,0,0,[]
0x86b337be60c942e80f31e7be097de1ca821c5f7f,"[251, 252, 253, 254, 255, 256, 257, 258, 259, 260]",,10,10,0,0,[]
0xb347a88e0eb141b0f144e19cc3c2f14e31972dec,"[264, 265, 266, 267, 268]",,5,5,0,0,[]
0x3f87529a9b4e2ac329bad6fbe4e3dba2289ce18e,"[269, 270, 1332, 26]",,4,4,0,0,[]
0xc6d8997be1aa277bdfd2c24c669aa4497f837a08,"[271, 272]",[3086],3,2,1,1,[271]
0x6013782ea371e1fde1624347a8b845c7fa07a9c7,"[283, 284]",[1281],3,2,1,1,[283]
0x5e2932ae0f443e211e23fdb99269bb89343a52cf,[285],[1535],2,1,1,1,[285]
0x0d86a2fd448ad216692238a28d2753def5b1d853,[291],,1,1,0,0,[]
0x71465eee3770129a550e0faca070f8404f998ff2,"[292, 293]","[2492, 2493]",4,2,2,2,"[292, 293]"
0x6dd497300f0d946b766c44c63af1583e2707f3cd,[294],,1,1,0,0,[]
0x0f07081f7e8cefc992c6ef585d5b26c8de4618f1,[329],,1,1,0,0,[]
0x85d26a86c15325f64881511499b917a685e814d3,"[296, 297]","[977, 976]",4,2,2,2,"[296, 297]"
0xde8d80a173df549eda90b42adc21165154233be8,"[298, 299]","[1751, 1752, 1753, 1754, 1755, 2108, 2109, 2110, 2111, 2112, 2123, 2124, 2125, 2126, 2494, 2495, 2496, 3338, 3339, 3340, 3341]",23,2,21,2,"[298, 299]"
0x0b4ecf28692614c10deb7d8579f4878be3fd2de9,[300],,1,1,0,0,[]
0x1daf40da0e2e9e4a17e0aaa10daedb2be9ccc000,"[962, 1551]","[518, 1774]",4,2,2,2,"[962, 1551]"
0xdf658c84618ee9c92032bd232641e006957a9d17,[303],,1,1,0,0,[]
0x38fbdbbc8a757d2a4fb245b51f51256fdec911f0,"[304, 305]","[1749, 2518, 2519, 2520, 2521, 2522, 2523, 2524, 2525, 2526]",12,2,10,2,"[304, 305]"
0x1d0d61ee595d56937465ae9675cb3e7e3ef914b1,[306],"[458, 459, 460]",4,1,3,1,[306]
0xb47b752d27de51a9d84d0f0d1d74bc099d7aada9,"[307, 308]","[1598, 1599, 1600]",5,2,3,2,"[307, 308]"
0xf8f2b20a1ecbf962627b21b539c12b9463abf29c,"[309, 310, 311, 312]","[502, 503, 504, 505]",8,4,4,4,"[309, 310, 311, 312]"
0xea5471ba9a40f958f23a4cb483b7074833194a77,"[313, 532, 533]","[240, 242, 237, 241, 243]",8,3,5,3,"[313, 532, 533]"
0x1d8f3e01f2ed23a479c73c0e8295a328710ebfb8,"[316, 317]","[553, 554, 555, 556, 557]",7,2,5,2,"[316, 317]"
0x9ca2f80920d526ade9bd32f0a6da393ff23de02c,"[320, 322, 323, 325, 319]",,5,5,0,0,[]
0x07c5c922a770cc1326d9b4ae76d3e3b9eca3fafc,"[338, 339]","[169, 180, 170, 179, 1429, 178, 171, 172, 173, 174, 1303, 1286, 1076, 1538, 175, 176, 177, 1777, 1778, 1779]",22,2,20,2,"[338, 339]"
0x37a48a4a9f7ada3cd95684d2e790d85f36b1640a,"[344, 345, 346, 347, 348]","[224, 225, 226, 227, 228, 1222, 1223, 1224, 1225, 1226, 1227, 1228, 1229, 1230, 1231]",20,5,15,5,"[344, 345, 346, 347, 348]"
0x3f24a07736b4ad354366b57e6ba49a2174175df0,[349],[1279],2,1,1,1,[349]
0x48c8786c66c95f14745156e9613eb76778cb3055,[350],"[445, 446, 447]",4,1,3,1,[350]
0x4cb590e6dc286c9b3694b75bb22f40abf8c79e3d,"[351, 352, 353, 354]","[450, 451, 452, 453]",8,4,4,4,"[351, 352, 353, 354]"
0xa7e5e873c6ac654296109d34e99d6378cb4b94d4,"[355, 356, 357, 358, 359, 754, 755, 756, 757, 758, 759, 760, 761, 762, 763, 764, 765, 766, 770, 774, 767, 771, 768, 769, 772, 773]",,26,26,0,0,[]
0x8701492d3996a3fdf70bf031237dceff02d792db,[360],,1,1,0,0,[]
0xf1a75b9d95302c1bb27c04853ef66863411700cd,"[362, 363]","[190, 191, 192, 193, 194, 195, 196, 197, 198, 199, 1819, 1820, 1821, 1822, 1823, 1824, 1825, 1826, 1827, 1828, 1829, 1830, 1831, 1832, 1833, 2908, 2909, 2910, 2911, 2912, 3003]",33,2,31,2,"[362, 363]"
0x56abbf32376d57b1c6ea2ebeb939f4256e536817,[364],,1,1,0,0,[]
0xa0d6e23c10c2c4331264c59e01a5483a22b1d543,"[365, 366, 367, 368, 369, 370, 371, 372, 373, 374]",,10,10,0,0,[]
0x6530d9a19e2c2e737b7ecc4facf51df979be344e,"[379, 380, 381]","[1132, 1903]",5,3,2,2,"[379, 380]"
0x5c63ef37e533ea8ce592b0cf9aa071bc9b7b1fd0,[382],,1,1,0,0,[]
0x79dd098dcdd2e0432fb64dc38f921e6c40ce268e,"[384, 383]",,2,2,0,0,[]
0xa899d806b94980c908a5d278c27f015790cd9b59,[385],"[2771, 2772, 2773, 2774, 2999]",6,1,5,1,[385]
0x1c4ebbee1470993473825fd548c48aab22b7c345,"[1552, 387, 961, 1780, 1821, 1822]","[16, 2989, 896, 897, 900, 899]",12,6,6,6,"[1552, 387, 961, 1780, 1821, 1822]"
0xef8a3991bc37517f6426b996df42e25fa4eeeecb,[388],,1,1,0,0,[]
0x68cdf43c4d7b82dd2112701ca51a4256c20dcdef,[389],"[634, 635, 636, 637]",5,1,4,1,[389]
0x133affeac516c021c520e56e6c7546cfa2c47089,[390],,1,1,0,0,[]
0xbea0dccd9937213a468c9203a40faeb915916c42,"[391, 392, 393]","[841, 2597, 2217]",6,3,3,3,"[391, 392, 393]"
0x9253651043727d6a2f56b80fabddad8a99cf8909,"[394, 395, 396, 397, 398, 399, 400, 401, 402]",,9,9,0,0,[]
0x2a105464a47181bac686a522f3948ac27cdbd1f2,[403],"[398, 399, 400, 401, 402, 403, 404, 405, 406, 407, 408, 409, 410, 411, 412, 413, 512, 1316, 417, 416, 415, 414, 2684, 2685, 2686, 2687, 2688, 2689, 2690, 2691, 2692, 2693, 2694, 2695, 2696, 3224, 1688]",38,1,37,1,[403]
0x0194b6a48d0f9dcb5a66c9068776d0327f28c2ae,[404],[828],2,1,1,1,[404]
0x7a205a4a5f1cc04cfa751b030322804a0eb42d33,[405],"[853, 854, 855]",4,1,3,1,[405]
0x9654dd5c7031c9d24c8b8c309ed89f2a47ce0d0b,"[406, 407]","[1445, 1446, 1447, 1448, 1449, 1450, 1451, 1452, 1453, 1454, 2513, 2514, 2515, 2516, 2529, 2530, 2531, 2532, 2533, 2534, 2535, 2536, 2537, 2538, 2539, 2540, 2541, 2542, 2543, 2544, 2545, 2546, 2547, 2548, 2549, 2550, 2551, 2552, 2553, 2554, 2555, 2556, 2557, 2558, 2559, 2560, 2561]",49,2,47,2,"[406, 407]"
0x1ee0cdae650611c5ce6e92a2d3457e0092b5e68d,"[408, 409, 410, 411]","[2608, 2604, 2606, 2607]",8,4,4,4,"[408, 409, 410, 411]"
0x42e2002b473f9fe2db46413d4df29d3b451604c1,[412],,1,1,0,0,[]
0xa053d2408056f6d96afb0b7cc69ad2500052a6cd,"[413, 414]","[1456, 1457]",4,2,2,2,"[413, 414]"
0x363559f37127a1afe087a1a3a584e91d187105d6,"[415, 416]","[434, 428, 429, 430, 431, 432, 433, 1104, 1122, 1105, 1106, 1107, 1108, 1109, 1110, 1111, 1112, 1113, 1114, 1115, 1121, 1120, 1119, 1118, 1117, 1116, 1517, 1518, 1519, 1520, 1521, 1522, 1523, 1524, 1525, 1526, 1527]",39,2,37,2,"[415, 416]"
0x6e8ad781e0c1ade55d5a609de13a17eb0e5b1a07,[417],[707],2,1,1,1,[417]
0x66bc7a339c214e0cb34526632f96da299c50617e,[418],"[422, 423, 424, 425, 426, 2747, 2748, 2749, 2750, 2751]",11,1,10,1,[418]
0x359588bde28dae0a75a7e40e0b36b53abe9ec02d,"[419, 468]","[1068, 1069, 1070, 2241, 2242, 3291]",8,2,6,2,"[419, 468]"
0xf395a38beed93980a3173bd79e63d5b87d628d32,[421],,1,1,0,0,[]
0x0154f23ac0de4a7679b9a9eb7ba7dac2e67c82f5,[422],"[273, 274, 275]",4,1,3,1,[422]
0x098d199b196a792abcd6f4aaa4fff194882879e9,"[423, 424, 425, 426, 427, 428, 429, 430, 431, 432, 433, 434, 435, 436, 437, 438, 439, 440, 441, 442]","[2966, 3046, 2965, 531, 527]",25,20,5,5,"[423, 424, 425, 426, 427]"
0xb3ac1fe1644ee154157f86953dbea96b46bb29ae,"[443, 444]","[349, 3039]",4,2,2,2,"[443, 444]"
0x331268660718c334102eb134412a1a77b7ae1cf1,[447],[52],2,1,1,1,[447]
0x417f20de717caf7495d560bc6d4c4db59bcc9a0b,"[449, 450, 451]","[1495, 1496, 1497]",6,3,3,3,"[449, 450, 451]"
0x7fc283ef4a8ee4435108ef8736771d065321c44f,[455],[587],2,1,1,1,[455]
0x5355285e6621f840da2aa1eadfa5539ef3784529,"[456, 457, 458, 459]",,4,4,0,0,[]
0x44f3b69326ee6bec136d3611f8f192de7a6bd887,[460],"[2114, 2115, 2116]",4,1,3,1,[460]
0xb6f235568553da42b03b59483047e10d3c3319bf,[461],"[1060, 1061, 1878, 1879, 2224, 2225]",7,1,6,1,[461]
0x110fcf343649934efc436b47d77c825214865467,"[463, 464]","[1289, 1714]",4,2,2,2,"[463, 464]"
0xb0fd2c2729434e1002d75f6b46e7fd288ff229a0,[494],,1,1,0,0,[]
0x7a15b89d2289c57c2c1ff84109c52d5620631784,"[495, 496, 497, 498, 499]",,5,5,0,0,[]
0x5847c3768c5e0c66261f0b8ac579c6a3abc671ff,"[491, 207, 208]","[850, 851, 852]",6,3,3,3,"[491, 207, 208]"
0x1dad7fadd8cc0931d488303aeef5fc4db89093ce,"[500, 501, 502, 503, 504, 505, 506, 446]","[50, 51, 53, 54, 55, 56, 57, 59, 60, 61, 62, 63, 64, 65, 66, 67, 68, 69, 70, 71, 72, 73, 74, 75, 76, 77, 78, 79, 80, 81, 82, 83, 84, 85, 86, 87, 88, 89, 90, 91, 92, 93, 94, 95, 96, 97, 98, 99, 100, 101, 102, 862, 3262, 3263, 3264, 3265, 3266, 3267, 3268, 3269, 3270, 3271, 3272, 3273, 3274, 3275, 3276, 3277, 3278, 3279, 3280, 3281, 3282]",81,8,73,8,"[500, 501, 502, 503, 504, 505, 506, 446]"
0x70031213c95deecfa44a6c438bca25134a292eef,"[507, 508, 509, 510, 511, 512, 513, 514, 515, 516]",,10,10,0,0,[]
0x7294383778143546b6c2096ea7665f3b894d7a26,"[517, 518]",,2,2,0,0,[]
0x5b266444c21f6e97de7da4231b60c713e59e4f6b,[519],"[143, 144, 145, 146, 147, 148, 149, 150, 151, 152, 153, 154, 155, 156, 157, 158, 159, 160, 161, 162]",21,1,20,1,[519]
0x3e85dd6a9e4fda5f33685b7a5bc588e972781b12,[520],,1,1,0,0,[]
0x38dfe6658b46e1b8394434944a5ca93abbb1b498,[521],,1,1,0,0,[]
0x6b09ac17938055e0a81ded39e79524129a7ef587,[522],,1,1,0,0,[]
0xfc7035d84a37e65e6e8315747b85ca87d68e4722,"[523, 524]",,2,2,0,0,[]
0x68a8fff106fef3c58e9dc9e2bd62e4b79e39ba8c,"[525, 526]",,2,2,0,0,[]
0x7d004448c8205ebec5d80d04c2dcb04e8ca5f074,"[530, 531]",,2,2,0,0,[]
0xbd3506e8b10193729302c9cf1b865dffe6cbb2c8,[534],,1,1,0,0,[]
0xea3f0d652cfb0bbc588fbc10723f537dfcf47430,[535],"[497, 498, 1555, 1556, 2214, 2215]",7,1,6,1,[535]
0xa3aa0d39f2036cf3ee3a182763423850f223fdad,"[536, 1540, 1544, 691]","[1647, 1648, 1649, 2876, 2877, 2878, 2879, 3318]",12,4,8,4,"[536, 1540, 1544, 691]"
0x1a641b39d3a366b275f13ac11038f56dadc97be7,"[537, 538, 539]",,3,3,0,0,[]
0xe4d41f491bf2de6ee596178caab3c1f30926dc1b,"[540, 541]",,2,2,0,0,[]
0x1a2b288b13aa1485c3381342c655718188815298,"[543, 544]",,2,2,0,0,[]
0xdba0f30a267203b010bda96e8c40afb935d41495,[547],[768],2,1,1,1,[547]
0x95b43f40acb2d4972d2b274bd57f928b7e684e78,"[548, 477, 478, 479, 480, 481, 482, 483, 484, 485, 486]",[592],12,11,1,1,[548]
0x2f1e8158a8d7bfc325de7682f72cd16ecaa96267,[549],,1,1,0,0,[]
0x02f8e6b32d840607858b87975922b98375a709e5,[550],"[1071, 1072, 1073, 1074, 1075]",6,1,5,1,[550]
0xce325a6fe7b6cb6a5cedc0d83564c03713518d9b,"[553, 554]",,2,2,0,0,[]
0x0c4a19ae016dc2803b1ff6d8380999295b1272a0,"[567, 568, 569, 570, 571, 572, 573, 574, 575, 895]",,10,10,0,0,[]
0xfed858460237b6aa3bfc85f9a9634198521d50dd,"[935, 617, 618]","[3001, 529, 2971]",6,3,3,3,"[935, 617, 618]"
0xcda91831ab6cffd98ba9e9c2645bb24b9368bfbf,"[622, 623, 624]","[2505, 2506, 2507, 2508, 2509, 2510, 2511, 2512, 2975, 2977, 2978, 2979, 2980, 2981, 2982, 2983, 2984, 2988, 2958, 2957, 2959, 2991, 2954, 2953, 2952, 3000, 2949, 2951, 2950, 3010, 2947, 2948, 2946, 3021, 2943, 2942, 2944, 3029, 2937, 2938, 2936]",44,3,41,3,"[622, 623, 624]"
0x470229690abf2de046b22aa0059b98abcab362c9,[625],[217],2,1,1,1,[625]
0xd9c925e7db3c6f64c2b347107cafdc75390a8744,[626],,1,1,0,0,[]
0xc964487aa09262457984207d8461a2399a871d0e,[493],,1,1,0,0,[]
0x8c4b9dac7b3a96e7f4d265dcdd3e026cb5bd2804,"[627, 629, 630]","[3004, 3005, 3006, 3007, 3008]",8,3,5,3,"[627, 629, 630]"
0x822a505c1d70a6241400cd69dc193bd701634b66,"[632, 633]","[1561, 998]",4,2,2,2,"[632, 633]"
0x3ed78ae771b3d1b9d3838ac87b27af346115507a,"[634, 635, 636, 637, 638]",,5,5,0,0,[]
0x6d52d78274a5ecbed86f89ceaede7c8b8d3c5618,"[639, 640, 641, 642, 643, 644, 645, 646, 647, 648, 942, 945, 939, 944, 937, 943, 941, 938, 946, 940]",[2157],21,20,1,1,[639]
0x6b1ee35001fc72ef2af0e64fc3c9ad0d670eeb43,[649],"[1317, 1318, 1319, 1320, 1321, 1713]",7,1,6,1,[649]
0xbb581dc0109308c3b1b833d326c1b1c0ab0423af,[650],,1,1,0,0,[]
0x9b44c274024bda734ed2e1acf3124f9b54cb3de7,[651],,1,1,0,0,[]
0xffc4a9cd6d4fc0b951621c9a66cf89d1533a4444,[653],[999],2,1,1,1,[653]
0x76d09c248dd798482c51a302e46a4e097b654a17,[654],"[419, 2765, 2766, 2767, 1696]",6,1,5,1,[654]
0x3de7ad5217e9ce76aa97413a692a65faf193158b,[655],[214],2,1,1,1,[655]
0x1f906ab7bd49059d29cac759bc84f9008dbf4112,"[656, 657]","[356, 355, 2933, 2934]",6,2,4,2,"[656, 657]"
0x708de5e4e315b016ab9febde8a509af84db084ee,"[658, 659, 660, 661, 662, 663]","[2489, 2490]",8,6,2,2,"[658, 659]"
0x479a237b17da762b506b2e8d4447a15257bde2f1,[664],,1,1,0,0,[]
0xa022e0142ce1c4a382b7f3eff03ad246963125c5,[665],,1,1,0,0,[]
0x1a0d0f85d9630190739ef57c2f49bf823430cddc,"[666, 667, 668, 669]","[437, 438, 439, 440, 441, 442, 443, 444, 2903, 2904, 2905, 3302, 3303, 3304, 3305, 3306, 3307, 3308, 3309, 3310, 3323, 3324, 3325]",27,4,23,4,"[666, 667, 668, 669]"
0xc7b5e0f6d66cd2099d28edb33f7e4e0ecec80b2b,"[670, 671, 672, 673, 674]",,5,5,0,0,[]
0x6ec2c00a6c71e2ab90e50d39ff32298b1343625e,"[676, 677, 678, 679]",[2609],5,4,1,1,[676]
0x88ad72540c2a4bd0cf4079a1583900dd73816716,"[680, 681]",,2,2,0,0,[]
0x777517de59fe7a5b8d20a0ebfc8188ccb4ca03f3,"[682, 692]",,2,2,0,0,[]
0xb8358b31bca82989d3d6611911da3be38fe242f7,[167],[1180],2,1,1,1,[167]
0xbad979702a09841a7672fb6e3c12c3368dff2a19,"[683, 684, 685, 686]",,4,4,0,0,[]
0xeb1bcbfec30297e70ce7fda0a6729a233c957117,"[696, 1260]",[26],3,2,1,1,[696]
0x63fccb197aacc02dca13c7e5b150f1a81d1ccd5d,[698],"[3403, 3404, 3405, 332, 330, 328, 329, 331, 333, 334, 325, 326, 327]",14,1,13,1,[698]
0x581601353803dc4e8140458ba1b388a02b9a32e2,"[699, 700]",[2517],3,2,1,1,[699]
0x88e0a61798a3ced52f7654a5d79a90737f346631,"[701, 702, 703, 704, 705]",,5,5,0,0,[]
0x8aa9c34c1045c3f024066577ffb8349b1d44323f,"[800, 801, 802, 803, 804, 805, 806, 807, 808, 809, 810, 811]","[1011, 1010, 1102, 1103, 1342, 1344, 1578, 1738, 1787, 1786, 1579, 2136]",24,12,12,12,"[800, 801, 802, 803, 804, 805, 806, 807, 808, 809, 810, 811]"
0xba364aadfdb8b71dc111530baf078154374c4f2f,[707],,1,1,0,0,[]
0x0f356e10029fcaa866abc369594d5d19023238ca,"[713, 714, 715, 716]","[377, 378, 381, 380, 376, 374, 379, 382, 383, 375]",14,4,10,4,"[713, 714, 715, 716]"
0x4622c858deceda4d28a0fadf5e6ac17826aa73a4,"[720, 721, 722, 723, 724, 725, 717, 719, 718]","[2713, 2715, 2716, 2717, 2718, 2719, 2720, 2721, 2722, 2723, 2724, 2725, 2726, 2727, 2728, 2729, 2730, 2731, 2732, 2733, 2734, 2735, 2736, 2737, 2738, 2739, 2740, 2741, 2986]",38,9,29,9,"[720, 721, 722, 723, 724, 725, 717, 719, 718]"
0x05a84dac7d722e3313b5c94e2681baac3427ba76,"[727, 728]",,2,2,0,0,[]
0x40b11f8cfe3d22a0ece4731bb274b60187fea82a,"[734, 736, 737, 738, 739, 740, 741, 742, 743, 744, 745]",,11,11,0,0,[]
0x3564a55bde7ae750b44afe7b9271c1a6f23b93d2,[751],[2062],2,1,1,1,[751]
0x025030560d35493160ef3a2c96c4786eb6481ad9,"[752, 753]",,2,2,0,0,[]
0x85b2b25bcb79a4945c1d7ad5e773f4af5b7167c3,[775],[3409],2,1,1,1,[775]
0xc6eeadf321fa3d1c2a15f650a6995ea0496de394,"[776, 777]",,2,2,0,0,[]
0xd0d3890bde747517862805a089752425831ee680,"[778, 779]",,2,2,0,0,[]
0xd54a20fe797e6b67ff4b39da41a7fc14e507fe45,[780],"[281, 282, 2000]",4,1,3,1,[780]
0x21fe937690db6654d4cd3343e04a97fa8383be20,"[787, 788, 789, 790, 791]","[864, 865, 866, 867, 868, 869, 870, 871, 872, 873, 874, 875, 876, 877, 878, 879, 880, 881, 882, 883, 884, 885, 886, 887, 888, 889, 890, 891, 892, 893]",35,5,30,5,"[787, 788, 789, 790, 791]"
0xcb121cbb70ad7b8f567f7fbddb19a7423d0e0cb6,"[792, 793, 794, 795, 796]","[1440, 1441, 1442, 1443, 1444, 2244, 2245, 2246, 2247, 2248, 2249, 2250, 2251, 2252, 2253, 2254, 2255, 2256, 2257, 2258, 2259, 2260, 2261, 2262, 2263, 2264, 2265, 2266, 2267, 2268, 2269, 2270, 2271, 2272, 2273]",40,5,35,5,"[792, 793, 794, 795, 796]"
0x510cef61356f05c9280b94c84271c384457ed576,[797],"[1471, 1007]",3,1,2,1,[797]
0x0dc1b98f7d7a97e7877c063c18c187b8034d4bc4,[798],[107],2,1,1,1,[798]
0x8f62a92831b5d6c2f8099e98131d53bfda8684e8,[816],"[1251, 1252]",3,1,2,1,[816]
0x6e9a8a82beb9c5279e776f619ef60963458eba81,[817],[499],2,1,1,1,[817]
0xcf448ced3d8fd6bbe283533214401b226dafb9a2,[818],,1,1,0,0,[]
0xdbec81b4eab0b5234dbd9ff7c456bf750d7a9086,"[819, 820]","[267, 268, 269]",5,2,3,2,"[819, 820]"
0xb8067f9837376a004a596c069ab231bb5c56f6a1,"[821, 822, 823, 824, 825, 826, 827, 828, 829, 830, 831, 832, 833, 834, 835, 836]",,16,16,0,0,[]
0xd266d61ac22c2a2ac2dd832e79c14ea152c998d6,"[837, 838, 839, 840, 841, 842, 843, 844, 845, 846, 847, 848, 849, 850, 851, 852, 853, 854, 855, 856, 857, 858, 859, 860, 861, 862, 863, 864, 865, 866, 867, 868, 869, 870, 871, 872, 873, 874, 875, 876, 877, 878, 879, 880, 881, 882, 883, 884, 885, 886, 887, 888, 889, 890, 891, 892]","[247, 248, 249, 250, 251, 252, 253, 254, 255, 256, 257, 258, 259, 260, 261, 262, 263, 264, 265, 266, 657, 658, 659, 660, 661, 662, 663, 664, 665, 666, 667, 668, 669, 670, 671, 672, 673, 674, 675, 676, 677, 678, 679, 680, 681, 682, 683, 684, 685, 686, 687, 688, 689, 690, 691, 692, 693, 694, 695, 696, 697, 698, 699, 700, 701, 702, 703, 704, 705, 706, 956, 957, 958, 959, 960, 961, 962, 963, 964, 965, 966, 967, 968, 969, 970, 971, 972, 973, 974, 975, 1293, 1294, 1295, 1296, 1297, 1298, 1299, 1300, 1301, 1302, 1712, 2420, 2421, 2422, 2423, 2424, 2425, 2426, 2427, 2428, 2429, 2430, 2431, 2432, 2433, 2434, 2435, 2436, 2437, 2438, 2439, 2440, 2441, 2442, 2443, 2444, 2445]",183,56,127,56,"[837, 838, 839, 840, 841, 842, 843, 844, 845, 846, 847, 848, 849, 850, 851, 852, 853, 854, 855, 856, 857, 858, 859, 860, 861, 862, 863, 864, 865, 866, 867, 868, 869, 870, 871, 872, 873, 874, 875, 876, 877, 878, 879, 880, 881, 882, 883, 884, 885, 886, 887, 888, 889, 890, 891, 892]"
0x15daa9a6bd045b1820605089979413e027db5131,[893],[112],2,1,1,1,[893]
0x60c5f1a1b62c876520cb6156c49df2dfaaf34102,[901],[360],2,1,1,1,[901]
0x4907827081ed37528aa081ff5a9c246112cc2a82,[904],"[2317, 2318, 2319, 2320, 2321, 2322, 2323, 2324, 2325, 2326, 2327, 2328, 2329, 2330, 2331, 2332, 2333, 2334, 2335, 2336]",21,1,20,1,[904]
0x2ed9acb38d7d68219b56a8446f9b9b83d35bb0ea,[905],,1,1,0,0,[]
0x439710fc27b565372008657e854be116db01d4ca,"[906, 907]","[908, 909]",4,2,2,2,"[906, 907]"
0x6d6da26ee16599e9b7ba8e90adf984ac751f414a,"[908, 909, 910, 911, 912]",,5,5,0,0,[]
0x4cfff901a7393822ce74b7aa6c2f1d2b4aea859a,[913],,1,1,0,0,[]
0xf2a39b2037e3ef9ca0c71ae8d9d56de0d2b2b622,[915],[1601],2,1,1,1,[915]
0x03ae4ecadd9881b1017b37f4dca193f4f384c8e8,[916],,1,1,0,0,[]
0xeb55f0bdcdbfb1eecf13a4a867410b9830ab1e34,[917],,1,1,0,0,[]
0x69d35a760ee88242a3a9e97fd85c8bb272d0e7e2,[918],[456],2,1,1,1,[918]
0x61adf0b7419e09d8e3c72de5d007c593475226c3,[919],,1,1,0,0,[]
0x00801180685476dd2cb0718b87114412cf37a39b,[920],"[1637, 1638, 1639]",4,1,3,1,[920]
0x1f655685a4876fdb56da897118f67824d279abe5,[921],"[1642, 1641]",3,1,2,1,[921]
0xc26b9af0043afbb8d20f94b9b3c753aae7f2a3e9,[922],,1,1,0,0,[]
0x18a4e9b06065c447f68c05c213a0670f92f60c7f,"[923, 924]",,2,2,0,0,[]
0xc84f2a72b6dbce73ef285d80b60f1b285e88196f,"[925, 926]",,2,2,0,0,[]
0x0c362da25cb629497e1cab87ee14cc4d4fda3b58,"[930, 931, 932]",,3,3,0,0,[]
0x82d60bf46cd393385163e4609ae035ad96dd5fc6,[933],,1,1,0,0,[]
0x6aa5bbf2164e9e0c36535f7f910f59b7fcc62acb,[934],[1422],2,1,1,1,[934]
0xb1a02362c722a20622e5e8325a0e180aac79e391,"[153, 1766, 321]",,3,3,0,0,[]
0x3f8f595acd71161e9f176bcfa97e2cb519c58823,"[948, 949, 950]",,3,3,0,0,[]
0xb29442f06d1cfbdad92215c463d97b8a230cf4f4,[957],[1126],2,1,1,1,[957]
0xf2d57c65c7de00037c5222741c36f7b4ff32f306,[958],"[1138, 1137, 1139]",4,1,3,1,[958]
0x57f65790fa373e1c74ec570048a2c7b10668ad93,[959],,1,1,0,0,[]
0xf93ef9cb0fc73b710ca1fb4a0c4f671d3201390f,[960],,1,1,0,0,[]
0xd6fc89004c5aa526a13407b37a03d700df0b2eaf,"[963, 964, 965, 966, 967]","[1064, 1067]",7,5,2,2,"[963, 964]"
0x52207ae490cc6b127d4bff79a2158a569c4f0e33,"[968, 969, 970]","[1065, 2140, 2141, 2142, 2143, 2144, 2145, 2146, 2147, 2148, 2149, 2150]",15,3,12,3,"[968, 969, 970]"
0x7d0d80faa43b97bdb47a1af709b5b30cb2fb055d,[971],[1066],2,1,1,1,[971]
0xb5c6d75678927ddf54b2ea25b87ba5f3588b23cc,[972],[189],2,1,1,1,[972]
0xd5db43b60893bdff5582edab78892ae6d50a78b2,"[973, 974, 975]","[3012, 3011, 103, 104, 105, 106, 116, 113, 114, 115, 110, 109, 111, 108]",17,3,14,3,"[973, 974, 975]"
0xc04b7d464c724c8d4d5fe6067938cedab82afa12,[977],,1,1,0,0,[]
0x36b921bd2015c14f2a18085d20c39de765f25f6d,[980],,1,1,0,0,[]
0xca3e3ff71782cda9fb5a7f2234287061f141e881,"[986, 987, 988]",,3,3,0,0,[]
0x1e75722c5f8b29e4103ac051d3b805b6bc9300d5,[991],,1,1,0,0,[]
0xaed9c6bd88206ac058ac2ff0b53f070576738341,"[992, 993]",,2,2,0,0,[]
0xdf4c9088cae0a07b8f1f5efd8b79a4e750ec3945,"[994, 995, 996, 997, 998, 999, 1000, 1001, 1002, 1003, 1004, 1005, 1006, 1007, 1008, 1009, 1010, 1011, 1012, 1013, 1014, 1015, 1016, 1017, 1018, 1019, 1020, 1021, 1022, 1023]",,30,30,0,0,[]
0x18aed45a7bb952fe4d090c06605d6ef28c4d85d5,[1024],,1,1,0,0,[]
0xbaa68353fd63cc44fa2ac9c77faca4c588d5a8ae,"[1026, 1027]","[1486, 1487]",4,2,2,2,"[1026, 1027]"
0x6f21ded5c3e30151cd7d7a01fb71c54f6db46355,"[1028, 1029, 1030]","[385, 386, 387, 388, 389, 3023, 3024, 3025, 3026, 3027]",13,3,10,3,"[1028, 1029, 1030]"
0xb2c5ae080a236fe89a87fdbd1f9d58ad4b57c6b2,"[1031, 1032, 1033, 1034, 1035, 1036, 1037, 1038, 1039, 1040]","[137, 138, 139, 140, 141]",15,10,5,5,"[1031, 1032, 1033, 1034, 1035]"
0x3d1b1f3f3ef3ceb824a472d99d89d95aab385274,[1041],,1,1,0,0,[]
0xa900d1f896ace6c7bdb403bc660ffbb682386b0e,[1043],"[31, 32, 33, 34, 35]",6,1,5,1,[1043]
0x528bc3726f076ebc29d5cc83c66de21ba25a8ae0,[1044],"[320, 321, 322, 323, 324, 3295, 3296, 3297, 3298]",10,1,9,1,[1044]
0x5e0bf28934797cce28bdef8221182bdf82eba68a,"[1045, 1046, 1047]","[208, 392, 393, 394, 395, 396]",9,3,6,3,"[1045, 1046, 1047]"
0xe3bca03b772ddbe7fc806da5df6345c59961bfc9,"[1048, 1049, 1050, 1051, 1052, 1053, 1054, 1055, 1056, 1057, 1058, 1059, 1060, 1061, 1062, 1063, 1064, 1065, 1066, 1067, 1068, 1069, 1070, 1071, 1072, 1073, 1074, 1075, 1076, 1077, 1078, 1079, 1080, 1081, 1082, 1083, 1084, 1085, 1086, 1087, 1088, 1089, 1090, 1091, 1092, 1093, 1094, 1095, 1096, 1097, 1098, 1099, 1100, 1101, 1102, 1103, 1104, 1105, 1106, 1107, 1108, 1109, 1110, 1111, 1112, 1113, 1114, 1115, 1116, 1117, 1118, 1119, 1120, 1121, 1122, 1123, 1124, 1125, 1126, 1127, 1128, 1129, 1130, 1131, 1132, 1133, 1134, 1135, 1136, 1137, 1138, 1139, 1140, 1141, 1142, 1143, 1144, 1145, 1146, 1147, 1148, 1149, 1150, 1151, 1152, 1153, 1154, 1155, 1156, 1157, 1158, 1159, 1160, 1161, 1162, 1163, 1164, 1165, 1166, 1167, 1168, 1169, 1170, 1171, 1172, 1173, 1174, 1175, 1176, 1177, 1178, 1179, 1180, 1181, 1182, 1183, 1184, 1185, 1186, 1187, 1188, 1189, 1190, 1191, 1192, 1193, 1194, 1195, 1196, 1197]",,150,150,0,0,[]
0xb165e2d09a3de54ece671ee5d52c73e55c98376d,"[1199, 1200, 1201, 1202, 1203, 1204, 1205, 1206, 1207, 1208, 1209, 1210, 1211, 1212, 1213, 1214, 1215]",,17,17,0,0,[]
0x76fb233cd822ba4acfc679fb46614cdc6d31afec,"[1228, 1219, 1220, 1221, 1535, 1532, 1224, 1536, 1226, 1227, 1592, 1593, 1594, 1595, 1596, 1597, 1598, 1599, 1600, 1601, 1602, 1603, 1604, 1605, 1606, 1607, 1608, 1609, 1610, 1611, 1612, 1613]",,32,32,0,0,[]
0x200d3810bb24fde83b790b9169f9e228b00522ca,[1231],,1,1,0,0,[]
0x791daf4cbe8e302d841047a5e1c4b5f8218c8e12,[1232],"[1014, 1015, 1016]",4,1,3,1,[1232]
0xbb2a7af8d40a22ea8690b182f7a95d8a77770cfe,[1233],,1,1,0,0,[]
0xe903178c049d4e0ec6bfe76b01aa753874c507fd,[1234],,1,1,0,0,[]
0x644be8a25be30a21e2dffeae4fc43937fbcf3efd,"[1235, 1236, 1237, 1238, 1239, 1240, 1241, 1242, 1243, 1244, 1245, 1246, 1247, 1248, 1249, 1250, 1251, 1252, 1253, 1254, 1255]","[562, 563, 564, 565, 566, 567, 568, 569, 570, 571, 572, 573, 574, 575, 576, 577, 578, 579, 580, 581, 582]",42,21,21,21,"[1235, 1236, 1237, 1238, 1239, 1240, 1241, 1242, 1243, 1244, 1245, 1246, 1247, 1248, 1249, 1250, 1251, 1252, 1253, 1254, 1255]"
0x64b1a15d334d53aac1d21ea6aa66169077a2de03,[1256],[757],2,1,1,1,[1256]
0xaa492fbe2659d9a574234ac23a1e8818aa55a0f2,"[1257, 1258]","[750, 751]",4,2,2,2,"[1257, 1258]"
0x929fcfac98b7e6a302c2f9669ad6c0c37f9da71d,[1259],,1,1,0,0,[]
0x396b0f3e926ff3e4e87526f3e0021536d6503058,[1261],"[1390, 1391, 1392, 1393, 1394, 1395, 1396, 1397, 1398, 1399, 1400, 1401, 1402, 1403, 1404, 1405, 1406, 1407, 1408, 1409, 1410, 1411, 1412, 1413, 1414, 1415, 1416, 1417]",29,1,28,1,[1261]
0x34b1a03882de980380a597d9fda7b2c24164267b,[1262],,1,1,0,0,[]
0x63d2d24aee2ecc3fc4b25c7d27b1f535653de774,[1263],"[843, 844, 845, 846, 847]",6,1,5,1,[1263]
0x8240b5883765189923c7d09b216c060a3923e1c6,[1264],[936],2,1,1,1,[1264]
0xa6172df9d82d9a76dd519f0e65283f25532506d0,[690],"[2586, 2587]",3,1,2,1,[690]
0x0a3f8fcfa61171c02ab044add42638aa58ba62d2,[1265],"[2137, 2138, 2139]",4,1,3,1,[1265]
0x4895e139f31444d2bd87de36ad86f7f2ae6114c2,[689],,1,1,0,0,[]
0xb21472189ba2c2145b9823e8f678ff6fb62ef6f4,"[1266, 1268, 1269, 1270, 1271, 1272, 1571]",,7,7,0,0,[]
0xceb4aeefab4ef3dd80257d11d3546ac5daa5566d,[1273],"[203, 204, 205, 206, 207]",6,1,5,1,[1273]
0x97972b5904cfbe3ebe05dc17fd406382f9eaa3e5,"[142, 695]","[771, 772, 773, 774, 775, 776, 777, 778, 779, 780, 781, 782, 783, 784, 785, 786, 787, 788, 789, 790, 791, 792, 793, 794, 795, 796, 797, 798, 799, 800, 801, 802, 803, 804, 805, 806, 807, 808, 809, 810, 811, 812, 813, 814, 815, 816, 817, 818, 819, 820, 1498, 1499, 1500, 1501, 1502, 1503, 1504, 1505, 1506, 1507, 1562, 1563, 1564, 1565, 1566, 1567, 1568, 1569, 1570, 1571, 2025, 2026, 2027, 2028, 2029, 2030, 2031, 2032, 2033, 2034, 2880, 2881, 2882, 2883, 2884, 2885, 2886, 2887, 2888, 2889, 3240, 3241, 3242, 3243, 3244, 3245, 3246, 3247, 3248, 3249]",102,2,100,2,"[142, 695]"
0x90f7ea7d7f5e13f8a5d8b5f1e750e51657fbfb16,[1274],"[1187, 1421, 1594, 2472, 2929, 3097, 3098]",8,1,7,1,[1274]
0x852488cacb1096f9424b6701ba0ef11074f95ccf,[1275],,1,1,0,0,[]
0x12668431d5cf16a4117d24bbb448179a16ce9afd,[694],,1,1,0,0,[]
0x891b282bbacbad71d21b04cf2da7109688909236,[1276],,1,1,0,0,[]
0x46609553fb9940ecee893ca810060b3ee4d8216f,[1278],,1,1,0,0,[]
0x47ca90b4170a2ec0dbe7903c93eca2ca1a44e7bb,"[1279, 1280, 1281, 1282, 1283]",,5,5,0,0,[]
0x9dec09951ab3b1fc38150c10d6439cec58c788ac,"[134, 133]","[1465, 1464]",4,2,2,2,"[134, 133]"
0xde5add03d3b64eea046ba5da19679a307e67fd03,[1284],,1,1,0,0,[]
0x8d34913b1f9bbbbc86d15c293626bfc7a3eb81db,[1285],,1,1,0,0,[]
0x1710ef30e80b4ccfb064172b90682d51d57fe552,"[1286, 1287]",,2,2,0,0,[]
0xd100ad5de43cf6a1f74d318cc2e133c4097896b7,[1288],,1,1,0,0,[]
0xecb549091885ec38610a794ed13fcd0a4f3fba68,"[1289, 1290]",,2,2,0,0,[]
0xf217af9760ee7f261fc8b914b502b2a3a0f25695,"[1291, 1292, 1293]",,3,3,0,0,[]
0xfde2cc484d80c2fd2249e94f73d9818cbf25ff7f,"[1295, 1294]",,2,2,0,0,[]
0xbb36e5f759a96a515dd9b5bf33f29cb22f471b82,[445],"[2756, 2757, 2758]",4,1,3,1,[445]
0x6448bafaefc20b6bf55632adf93486a8c8e4a343,[1198],"[1607, 1608, 1609, 1610, 1611]",6,1,5,1,[1198]
0x8e87e4633c0478c3fe683564e14a29c946457f76,[529],,1,1,0,0,[]
0x2bd0320e62ba3900b155e01da61ee53c15820806,[1297],[3360],2,1,1,1,[1297]
0x39277ca1526ca59fffa74b5e960bcecca533d3cc,[1298],[2592],2,1,1,1,[1298]
0x8336210d5456a3e1485878b858ca144af8130dd1,[1299],,1,1,0,0,[]
0xd822e028290e993e76fabf36e5f19f29f7c951c8,[1300],,1,1,0,0,[]
0x535b76436be15c70de947585672df01c25a6e966,[343],"[313, 314, 1378, 3186, 3187, 3188, 3189, 3190, 3191]",10,1,9,1,[343]
0xb694ed18a0a8c68d5db6159f4cc4712b4035f340,"[1305, 1306]","[336, 337, 338, 1629, 1630, 3197]",8,2,6,2,"[1305, 1306]"
0x88c44ac39ddff25d9a706fc8991469eb56b27fa3,"[1308, 1309]","[640, 1095]",4,2,2,2,"[1308, 1309]"
0xd53d57ad9fcfd13ee5286e6cca809dc8346767fd,[1310],,1,1,0,0,[]
0x7bb3e5d1d340fc50842b483503a917428b9a1b8e,[1312],,1,1,0,0,[]
0x6e16416558d66d5e8a40814352f76e6435d772a4,[1315],,1,1,0,0,[]
0xa2d18c5ca7170c55aed88793f1b06386d1e20a2d,"[1316, 1317, 1318, 1319, 1320, 1321, 1322, 1323, 1324, 1325]","[1019, 1020, 1021, 1022, 1023, 1024, 1025, 1026, 1027, 1028, 1029, 1030, 1031, 1032, 1033, 1034, 1035, 1036, 1037, 1038, 1039, 1040, 1041, 1042, 1043, 1044, 1045, 1046, 1047, 1048, 1979, 1980, 1981, 1982, 1983, 1984, 1985, 1986, 1987, 1988, 1989, 1990, 1991, 1992, 1993, 1994, 1995, 1996, 1997, 1998]",60,10,50,10,"[1316, 1317, 1318, 1319, 1320, 1321, 1322, 1323, 1324, 1325]"
0xbbce4cbd4c1864af240c37a9a356f8898dadc4a2,[1326],,1,1,0,0,[]
0xd169d6e1a089d260146a1a4ad54c1c7009ee3f19,"[1338, 1334, 1336, 1333, 1339]",,5,5,0,0,[]
0xda65ae91bbc9212d5a12dec06a909547cb3b25df,"[1350, 1351]",,2,2,0,0,[]
0x1a4931493350e75d4a097fb2efbbcf180c00bb22,[376],[1620],2,1,1,1,[376]
0x7539880a9c9cf3be40751266812732bf73c99430,[1353],[1455],2,1,1,1,[1353]
0x9f3ce0ad29b767d809642a53c2bccc9a130659d7,[1354],"[1336, 1337, 1338, 1709, 2383, 2384, 2385, 2386, 2387, 2388]",11,1,10,1,[1354]
0x38959b0e61b0184de7a675538bb531878f89c26c,[1355],,1,1,0,0,[]
0x0777e3869fc2977bfbe2a41266ca90d93a8b8e03,[466],"[983, 984, 985, 986, 987, 988]",7,1,6,1,[466]
0xd8b4e3f564e26bbaba223c9781184f7ef5f7735d,[1356],[1736],2,1,1,1,[1356]
0xda9ef12e8c28126f87c2f1fbd7e5bef96ba855b2,[375],"[1484, 1536, 2022, 2466]",5,1,4,1,[375]
0x7a869e79b3772fd4d1bde39cba3d00e22e9639ca,"[1357, 1358]","[542, 541]",4,2,2,2,"[1357, 1358]"
0xd8144c8b699416bd11336d6f12eac178d8e31628,"[1359, 1360, 1361, 1362, 1363, 1364, 1365, 1366]",,8,8,0,0,[]
0x6f41fdef84da3c86a877e9761475b5dda7f814cc,"[1367, 1368, 1369, 1370, 1371, 1372, 1373, 1374, 1375, 1376]",,10,10,0,0,[]
0xf30715df42d704d3620bbf4c74395fdc044024d3,"[1378, 1379]",,2,2,0,0,[]
0xa52b9152b0917ac71cdc598caf71eea11d4d1e08,[1380],,1,1,0,0,[]
0x204e41100fa05e014cf4446334c72448f7134cef,"[1381, 1382]",,2,2,0,0,[]
0xc055afd03398b250ee0ac57f62179cde514e7066,"[1383, 1384, 1385, 1386, 1387]",,5,5,0,0,[]
0x4f928b9ba3f119ad35c1a82df12089fafb892b34,[1042],"[10, 19, 937, 1059, 1285, 1537, 1739, 2133, 2564, 3030, 3031, 3032, 3033, 3361, 3362]",16,1,15,1,[1042]
0xffed42426a5ebea28c4d26b75ce6201e9db1f391,"[1417, 1401, 1409, 1412, 1416, 1411, 1413, 1414, 1400, 1410, 1415, 1405, 1399, 1395, 1402, 1394, 1408, 1406, 1404, 1397, 1407, 1398, 1391, 1403, 1396, 1392, 1390, 1388, 1393, 1389]","[2181, 2182, 2183, 2184, 2185, 2186, 2187, 2188, 2189, 2190, 2191, 2192, 2193, 2194, 2195, 2196, 2197, 2198, 2199, 2200, 2201, 2202, 2203, 2204, 2205, 2206, 2207, 2208, 2209, 2210]",60,30,30,30,"[1417, 1401, 1409, 1412, 1416, 1411, 1413, 1414, 1400, 1410, 1415, 1405, 1399, 1395, 1402, 1394, 1408, 1406, 1404, 1397, 1407, 1398, 1391, 1403, 1396, 1392, 1390, 1388, 1393, 1389]"
0x747cf75dd86cf2aee26ea0076101cfa2496062de,"[1423, 1424, 1425, 1426, 1427, 1428, 1429, 1430, 1431, 1432, 1433, 1434, 1418, 1419, 1421, 1435, 1438, 1437, 1436]",,19,19,0,0,[]
0x86a41524cb61edd8b115a72ad9735f8068996688,"[1448, 1449, 1450, 1451, 1452, 1453, 1454, 1455, 1456, 1457, 1458, 1459, 1460, 1461, 1462, 1463, 1464, 1465, 1466, 1467]",,20,20,0,0,[]
0xb09363c9411cc96059a9d6c205d0c8cf49d72a21,"[467, 1825]",,2,2,0,0,[]
0x4803594505613806f44948ccef1643965efe4e1e,"[378, 929, 900, 898]","[2011, 2012, 2013, 2014, 2015]",9,4,5,4,"[378, 929, 900, 898]"
0xc42f23debda938555e3381eb9fde47feba645756,[1469],,1,1,0,0,[]
0xad68358989d5a2fbe75f8312e0b27b65bf134ac6,[43],"[2275, 2276, 2277, 2278]",5,1,4,1,[43]
0x9c87e30f90326238291e1c7d8a6b2640ec77360a,[1470],[2776],2,1,1,1,[1470]
0x20c24ae430b559da994a5898a8fd88fc951fc0cf,[1377],,1,1,0,0,[]
0xa864ddb21ac733ebb81e8b0b0dc88e35ab780587,"[1472, 1473, 1474, 1475]",,4,4,0,0,[]
0x075b7493389f02b32a61080b08f3a4690735baaa,[469],"[1493, 1557, 1558, 1559, 1560, 1580, 1581, 1582, 1583, 1584, 1585, 1717, 1718, 1834, 1835, 1836, 1837, 1838, 1839, 1840, 1841, 1842, 1843, 1844, 1845, 1846, 2402, 2403, 2404, 2405, 2406, 2407, 2408, 2409, 2410, 2411, 2412, 2413, 2414, 2476, 2477, 2478, 2479, 2480, 2481, 2482, 2483, 2484, 2485, 2799, 2800, 2801, 2802, 2803, 2804, 2805, 2806, 2807, 2808, 2809, 2810, 2811, 2812, 2813, 2814, 2815, 2816, 2817, 2818, 2819, 2820, 2821, 2822, 2823, 2824, 2825, 2826, 2827, 2828, 2829, 2830, 2831, 2832, 2833, 2834, 2835, 2836, 2837, 2838, 2839, 2840, 2841, 2842, 2843, 2844, 2845, 2846, 2847, 2848, 2849, 2850, 2851, 2852, 2853, 2854, 2855, 2856, 2917, 2939, 3066, 3067, 3068, 3069, 3070, 3071, 3072, 3073, 3074, 3075, 1492]",121,1,120,1,[469]
0x216a8bba8795c18f0d776ceb06c8b2568c2ec31f,"[1481, 1482, 1483, 1484, 1485]","[1156, 1157, 1158, 1159, 1160, 1161, 1162, 1163, 1164, 1165, 1166, 1167, 1168, 1169, 1170]",20,5,15,5,"[1481, 1482, 1483, 1484, 1485]"
0xeaf591460e7177616c3a7810bfe417eb654e2677,"[1486, 1487, 1488, 1489]","[455, 918, 919, 920]",8,4,4,4,"[1486, 1487, 1488, 1489]"
0x24095ec093e8dabcf36b04a4c36f1cadbc12a423,[528],"[1262, 2997, 3250]",4,1,3,1,[528]
0xd7987c20b0edf412c983c64688f7d1460e103e7a,"[1490, 1491, 1492]","[836, 837, 838]",6,3,3,3,"[1490, 1491, 1492]"
0xdec7b0e4397ebdec26e65f843bd5a2301ad54523,"[1493, 1494]","[2864, 2865, 2866, 3330, 3331, 3332]",8,2,6,2,"[1493, 1494]"
0xf7095529265630c72a7730579fbe7cbc241e3db8,[1496],,1,1,0,0,[]
0x15f4acc2f6505eef24226a678475d9925c668439,[1497],,1,1,0,0,[]
0x311271a02785b56fede851c2c896f894acf4b203,"[302, 125]","[1577, 738, 343]",5,2,3,2,"[302, 125]"
0x3d43bb8e1602a3387498806ae921dfd6aee7da3e,"[1502, 1503, 1504, 1505, 1506, 1507, 1508, 1509, 1510, 1511, 1512]","[293, 294, 295, 296, 297, 298, 299, 300, 301, 302, 303, 304, 305, 306, 307, 308, 309, 310, 311, 312]",31,11,20,11,"[1502, 1503, 1504, 1505, 1506, 1507, 1508, 1509, 1510, 1511, 1512]"
0xe15b96372421dd96297a46f6eab2a070f18e8cd4,"[1513, 1515, 1514]",,3,3,0,0,[]
0xbcc61d6061f187c3e730998f2cf9cc1d3b7aa026,[470],"[1100, 2794, 2795, 2796, 1702]",6,1,5,1,[470]
0x61e2299a65ddbfc54209ce8ab16c713e46f46780,[1314],,1,1,0,0,[]
0xd37c2ffe6300ee126d8eff1ac65194d95742e687,[377],[1663],2,1,1,1,[377]
0x8daf3e0051942f5cf2775149207c0725c082a899,[1516],,1,1,0,0,[]
0x584754814e314d3ccfd99a2ab024d075945c56c5,"[1517, 1518]",,2,2,0,0,[]
0xd5ce300682a28a16b46a5433a65ec54392c6a19a,"[1519, 1520]",,2,2,0,0,[]
0x1e271d2347de97709a9c809d42414fe0b7944991,"[217, 1539]","[2240, 2575]",4,2,2,2,"[217, 1539]"
0x981300b2e3322ee88fffbdb3dfe8cd5104d94908,[216],[1697],2,1,1,1,[216]
0x3a8e04d1c14fe2f90ee6da57abe451dddd6980e0,[218],"[3234, 3235, 3236, 3237, 3238]",6,1,5,1,[218]
0x5f881cd28943525fccb3543e92eaf30a06198961,[1499],"[1803, 1804, 1805, 2589, 2791, 2792]",7,1,6,1,[1499]
0xcacb488fc45ef21369ee1357ee2c344b885030ad,"[1521, 1522, 1523, 1524, 1525, 1526]",,6,6,0,0,[]
0x513e64dd22f4f7a86382d152e87a454573ae9872,"[1527, 1528]",[535],3,2,1,1,[1527]
0x73923eee89e55a8744ce751fcd116d90f5ee9127,[1529],,1,1,0,0,[]
0xba91d4c799903238aada246451d275bcc9872dea,"[1530, 1531]","[822, 825, 1680]",5,2,3,2,"[1530, 1531]"
0x58ecbc9b5ae73306fb948873a83c2c2e3742a015,[1330],[823],2,1,1,1,[1330]
0x521ecd541f6658447fa8ef3a4cf2ba5e9148958d,"[1222, 1230, 1229, 1223]",,4,4,0,0,[]
0xed66e340c877d8f05b4563d680ec06ad8b839569,"[471, 472, 473, 474, 475]","[3043, 3041, 3042]",8,5,3,3,"[471, 472, 473]"
0x3c0aa1cd80cfe7dcb13ea98c9631aeee0ee8f50c,[1307],,1,1,0,0,[]
0xbac9f09d124ab7032c519fd68a5992b914702656,[1501],,1,1,0,0,[]
0x08596d48fa0173e10767113da789ef507512c7da,"[1498, 1468, 1329, 896, 1328, 1327, 688, 927, 712, 710, 687, 706]","[2340, 2338, 2337, 40, 41, 37, 38, 39, 2341, 2339, 354, 1554, 769, 1703]",26,12,14,12,"[1498, 1468, 1329, 896, 1328, 1327, 688, 927, 712, 710, 687, 706]"
0xee0cc740a8793a3e574dcdcc191b48785a77669b,[476],"[1890, 1960, 1961, 1962, 1963]",6,1,5,1,[476]
0x479705e8d3dd43db2b5d0a0133d6ba650aca0abc,[1543],,1,1,0,0,[]
0x7e1ac186c823be8f064b36da6d73846d5858bc52,[44],"[1897, 1179]",3,1,2,1,[44]
0x56d0a40afaabc2469e2adef54a352947f0cc2743,[1542],"[2588, 2590, 2744]",4,1,3,1,[1542]
0xc72f318c7731c216875810f0948c2916b7d1e8b5,"[1545, 1546]",,2,2,0,0,[]
0x71acc33feea9cbe2ea03ee2808ab507bf2e8f3f6,[1547],,1,1,0,0,[]
0x0d3a1f049aa446737e2670b8033216b637e5609d,[1345],,1,1,0,0,[]
0xd75c230ce06c91a89ef4667aa98465dfb5d65ff7,"[1553, 1554, 1555, 1556, 1557, 1558, 1559, 1560, 1561, 1562, 1563]",,11,11,0,0,[]
0x86c4f1983ada6f36ff56d8892be6bbaa21decd90,"[1564, 1576]","[2960, 1705]",4,2,2,2,"[1564, 1576]"
0x2cefb2804a14ce00d9f1c72ac5f51b247499ee0c,"[1565, 1566, 1567]","[3047, 1343]",5,3,2,2,"[1565, 1566]"
0x0ef539b6feb1b63d72983eea075db83bf6554c70,[1569],,1,1,0,0,[]
0x9481a778cf7e76f654d370497e7607bab58d6194,[1344],"[344, 898, 352, 346, 515]",6,1,5,1,[1344]
0xeaf43d65dc8a3708b86f3bff44c08e0807b25355,"[282, 675, 1439]",[749],4,3,1,1,[282]
0xbd02b4bf5ef35c07ba3c4da3d17cca101727a281,"[1573, 1574]",,2,2,0,0,[]
0x6420e944e915bbfe8d3775ab062cfe778a62e179,[1575],,1,1,0,0,[]
0xdc066cb9347ab510cac2e9e680315f03d1af0c0f,[4],[3317],2,1,1,1,[4]
0x4579b9605cb0d84e2c0f829376e685383e869a88,[1577],,1,1,0,0,[]
0x09055d850dc88258eba0f69b1d2b4572f2358de8,[1578],,1,1,0,0,[]
0xa1eb0b1ffbf3af68caa8ef1ce80e4276a81a8894,"[1579, 1754]","[2956, 519, 2955, 520, 525, 524, 537, 534, 526, 532, 3356, 2389, 3355, 933, 2893, 2974, 3002, 1383, 1388, 1387, 1310, 1313, 1315, 1309, 1056]",27,2,25,2,"[1579, 1754]"
0x2ffc1626681c8e0fe0573017f47ba4bae543844b,[1580],,1,1,0,0,[]
0x2367432dc27e2e96b7ab8a0b0e4fcb28dd5a1c1f,"[1581, 1582]",,2,2,0,0,[]
0x6b45edda7c038af48f957dfc3cc37177893a17f5,"[220, 1500]","[530, 528]",4,2,2,2,"[220, 1500]"
0x56817017f910b7290ab118a185a24c1379b963a3,"[198, 199]",,2,2,0,0,[]
0xbe8dcad36698764a7b442d69cbaab6ca820b017f,[1583],"[1884, 3193]",3,1,2,1,[1583]
0xbc208f3f03187ff8ee6ab2c91e0c5dec2f109bdc,"[1349, 1347, 1348]",,3,3,0,0,[]
0xa4436ad09bf4d45330016d6ff5f21854f724dd99,"[1584, 314]","[2972, 358]",4,2,2,2,"[1584, 314]"
0x54f5645f98de9234f5eb0f48e767c3627d2182f2,"[551, 552]","[2996, 2994, 2992, 2993, 2995]",7,2,5,2,"[551, 552]"
0x6c9783784f6fcc5a8700634801e596b46a309d09,[1568],,1,1,0,0,[]
0x2aa3185ed5776ae255bf9d30cdc78ae8273fe139,[1590],,1,1,0,0,[]
0xa119c229769d4794e3974f6312af69190ca8b7a3,[711],[2059],2,1,1,1,[711]
0x629aca02aaa5e731f13e2ef60d931f464afc8f76,[979],"[1616, 1619, 1618, 1617]",5,1,4,1,[979]
0x889fa29f35e55324efd313a38c57409845e47134,[1591],,1,1,0,0,[]
0xcf5d096a821d937556482f0335622cf68b708130,"[1622, 1623, 1624, 1625]",[1892],5,4,1,1,[1622]
0xc32290f2e0a8405a2bd8db8863237de2f534f1c0,[708],,1,1,0,0,[]
0xa8420a80137210cc43ba3510f930024e3303875a,[709],[1140],2,1,1,1,[709]
0xbb642d8d7d3e18e8793a2a9f530444714fdb1c1b,[1627],,1,1,0,0,[]
0xa5f1d4f366dbfefb8ff8955823c07337ab6bd1d0,[1628],"[827, 1057]",3,1,2,1,[1628]
0xbac36308de557331a1bdc92af1333e795e08c9e0,[546],[1775],2,1,1,1,[546]
0x00f6dc16d719751fdbb44910d98c793fc45a736a,[1632],[826],2,1,1,1,[1632]
0x2303fb022541505776a8beb2fb7eb2b71cebac76,[489],,1,1,0,0,[]
0x08ab3f8da8ce47cd0e18a7e5c9a4f684fdc0af8a,[697],[3402],2,1,1,1,[697]
0x230439615e960c09d045f2a0591c9c21c8531f63,[1631],[824],2,1,1,1,[1631]
0xb203796e11234cb97b995ae50dc8a3e01ef9f9b6,"[1633, 1634, 1635, 1636, 1637, 1638, 1639, 1640, 1641, 1642, 1643, 1644, 1645, 1646, 1647, 1648, 1649, 1650, 1651, 1652, 1653, 1654, 1655, 1656, 1657, 1658, 1659, 1660, 1661, 1662, 1663, 1664, 1665, 1666, 1667, 1668, 1669, 1670, 1671, 1672, 1673, 1674, 1675, 1676, 1677, 1678, 1679, 1680, 1681, 1682, 1683, 1684, 1685, 1686, 1687, 1688, 1689, 1690, 1691, 1692, 1693, 1694, 1695, 1696, 1697, 1698, 1699, 1700, 1701, 1702, 1703, 1704, 1705, 1706, 1707, 1708, 1709, 1710, 1711, 1712, 1713, 1714, 1715, 1716, 1717, 1718, 1719, 1720, 1721, 1722, 1723, 1724, 1725, 1726, 1727, 1728, 1730, 1732]",,98,98,0,0,[]
0xe6d25f097f7ddbf22b71406f6beac259cc87f783,[1303],[0],2,1,1,1,[1303]
0xf78e40101da8a9ced4948cc600f7f6ef6d1f9107,[1302],,1,1,0,0,[]
0xca07f25fea21544cf0e19a4ad2540efe2eaf857e,[1589],,1,1,0,0,[]
0x0c1831988081e1deda8f41c7d3d62212b00e503a,[894],[947],2,1,1,1,[894]
0x8513d87583b89df12379a361b6f69343a211f66c,"[50, 978]","[1669, 2678]",4,2,2,2,"[50, 978]"
0xe321a425e23e188089a3b67ca6ddd740025a7479,"[1587, 1586, 542, 1733]","[536, 350, 3326, 533]",8,4,4,4,"[1587, 1586, 542, 1733]"
0x1eebf7d8c71c9800a9ee138e420f40fc77edba76,"[545, 210, 337, 813, 49, 48, 527]","[1742, 2674]",9,7,2,2,"[545, 210]"
0x67d355622dd9cf12a8c4626db6f2ac940e5deef3,"[1734, 1735]",[2155],3,2,1,1,[1734]
0x4893805237c891d717260f889673b01ab5d6f7d8,[928],[1437],2,1,1,1,[928]
0x2a2f892b50383b3aab780bd809512902219974dd,"[1495, 1313, 628, 631]","[2928, 2987, 2915, 2913, 2134, 1708, 1483, 1306, 1002, 2907]",14,4,10,4,"[1495, 1313, 628, 631]"
0x8c0424fe114b7af1b0aac8c99eda6486f1fc65d3,"[1736, 1737, 1738, 1739, 1740]",,5,5,0,0,[]
0x5d018d94e0561541f8b833b0d825b1c70c1db187,[814],"[2593, 2576]",3,1,2,1,[814]
0x027dfddb065783535cb18f066456063ceda248c4,[1741],,1,1,0,0,[]
0x778940ac3584060e17d34aac128f075fffafd90b,[487],,1,1,0,0,[]
0x0b1c8989ab868e3296b22254ef2914ae2754480d,"[1742, 66, 64]",[435],4,3,1,1,[1742]
0xc9554c227a8b78283f8938b81a54f3155a5e3996,[328],"[2861, 543, 3076]",4,1,3,1,[328]
0xd4e3f28e219f864b2cf99b3465431aebecbb14b7,"[1743, 1744, 1745, 1746, 1747, 1748]",,6,6,0,0,[]
0xde070f697da1e830eda3474534a117d039a2762c,"[902, 67]",,2,2,0,0,[]
0x7a9e2a02d8b060a0f614afec961feacb9dc24384,"[1749, 1750, 1751, 1752, 1753]",,5,5,0,0,[]
0x6ef5efb0c8ec34b19f00b4855f5a68c1c2d19bf0,[56],[830],2,1,1,1,[56]
0xc2da8aa49a387cc1d19ded1f37dc7c09941f0c1e,[1301],,1,1,0,0,[]
0xf2256fd67545a3cebc05d5570dd9c17350d3587e,"[1755, 1756, 1757, 1758, 1759, 1760, 1761, 1762, 1763, 1764]",,10,10,0,0,[]
0x1371f3b0ed087758dfe8895770f4a53272b4befb,[73],,1,1,0,0,[]
0xacefaa2185412c061c2a18f98be8ee9b0693f410,[47],[1142],2,1,1,1,[47]
0x98313dd41b1ca9b3ff4f78fcfebd9fc8f7ee64cc,"[72, 71, 70]",,3,3,0,0,[]
0x24971bd8e6670760b55acc827e31a548df7bf843,[69],,1,1,0,0,[]
0xf6dadf0293013e94fdd049f5860e79bfdec1841b,[65],,1,1,0,0,[]
0xc00bec72efcfbb92d4f31aa2c3492793db65feb8,"[135, 136]","[245, 246]",4,2,2,2,"[135, 136]"
0x4dd889b2b0038853aa82386ad7498812c3aecc97,"[1765, 60, 61, 1476]",[2135],5,4,1,1,[1765]
0x0bfffb5d6e30f4fb1b89978f76a0ea88e0ed4eec,[1767],,1,1,0,0,[]
0x725f87a90deff5e0bfdbd0c3cd9178a4563ab0cf,[492],,1,1,0,0,[]
0x6e109e2596b6f5bc581c6f85be4affe464b56693,[490],,1,1,0,0,[]
0x2f7f78b6856f107b8375ef8ed2e93094d762985a,"[1768, 1477]",,2,2,0,0,[]
0x410a84262804db5c2eeee59f4ad3b830640c45bd,"[1769, 1770, 1771, 1772, 1773, 1774, 1775, 1776, 1777, 1778]",,10,10,0,0,[]
0x55d8a375e242e8fa0aa7e37c99e75f20050e16b4,[1779],,1,1,0,0,[]
0x74807ae3cdd4054609e3dd51e951c815bc2c92d2,"[914, 936]","[1355, 713]",4,2,2,2,"[914, 936]"
0xa84843fb779cff10ae991978efb7b8c9c6dc3a2d,"[1781, 1782]",,2,2,0,0,[]
0x8d47db1f434c82b8c2fd0af377f8928e7aaefa95,"[566, 555]",[858],3,2,1,1,[566]
0xaa15e3bda1fc142fba7e06265a49cca92eb4cea0,"[606, 215]","[732, 1349]",4,2,2,2,"[606, 215]"
0xeca80a6b9644beb7ea6f9938f578ae7b35fafe91,"[1445, 1296]",,2,2,0,0,[]
0xe8614df35c74fe5dc75674eb5b9bdd5292aff0ea,[1447],[3327],2,1,1,1,[1447]
0xec49a1762296c91df150c165a5c53fb0f83eedb6,[1446],[391],2,1,1,1,[1446]
0x6c7133cd3fe9b39914c37957f4fc8830f68de482,[465],[1352],2,1,1,1,[465]
0xaa73f183a39251c0ff5746d63c76d962b65d412c,[386],,1,1,0,0,[]
0x727e9d6b8ce5f9c7032cc8d9d4cab7feb006c664,[62],[1326],2,1,1,1,[62]
0xb98fe4b96599bdd7a3505fcf7e6b756f1a61cf21,[63],[1333],2,1,1,1,[63]
0x3b7b8fdf3d5b35e079ec54fcc4207b02b1b15c61,[171],"[1334, 1335, 1327]",4,1,3,1,[171]
0xf7e859712811668b91888a5e1a00c4726dd42e5c,"[1783, 1784, 1785, 1786, 1787, 1788, 1789, 1790, 1791, 1792]",[421],11,10,1,1,[1783]
0x6d8903db4dec57290e0574923bddd1600eac65f8,"[124, 127]",[335],3,2,1,1,[124]
0xd14e31cc7a0bd4040d3bf58fbd45db5e82f5077f,[129],[1792],2,1,1,1,[129]
0x77f5fef8c8a18ac49e12330f2a3316fe3964ee24,[1794],,1,1,0,0,[]
0xc31885eba84d0ba29202e87df6e78d3e26c3a426,[126],,1,1,0,0,[]
0x4001af59a1d6eddff554a88f54e77fa6d5cc269e,[1795],,1,1,0,0,[]
0x39c08e7154016c0852890b973e7209f487ff2ef3,[213],[1332],2,1,1,1,[213]
0xd62ad3c0a52359a37f4329bbacd30ac063475998,[239],,1,1,0,0,[]
0x3edc5f13fab158c7f7f0f90d3f06b2bc6e4af42c,[128],[2156],2,1,1,1,[128]
0x858d4e9faa4c75d30acc6115819f9f77f03d9603,[1793],,1,1,0,0,[]
0x36d1872dd117fcd16880aa4685cfebff68029b15,[812],[1386],2,1,1,1,[812]
0xa7a1a9f794db7f161b008e963415c388a7ce4391,[1630],"[1367, 1368, 1369, 1376, 1370]",6,1,5,1,[1630]
0xb00c905bff63c245c12def03f56ffb49cf2f9ca7,[1796],,1,1,0,0,[]
0xd735fa50e1a259d8f85b5389dc1bd48e5d0ebe70,[1797],,1,1,0,0,[]
0x3cb40caee03bb77d576c146ab965c590c2a39427,"[1626, 27]",[1365],3,2,1,1,[1626]
0xfd17b21f2dc6bed7bd3ca5135a232b687aaae44f,[1798],,1,1,0,0,[]
0x3071820d9dc31c58ea4eb2387af2196f8e108166,[1478],,1,1,0,0,[]
0x5ebd70194265e8b8ad45cda25dcfc6d7e96e251a,"[68, 815]",[1701],3,2,1,1,[68]
0xfc9bede594847db537eb14e56753c05b7f515605,"[947, 620, 731, 1337]",,4,4,0,0,[]
0x6673de5b28292c6cff6e968d2472a849a6e74462,[212],"[2006, 2016, 2021]",4,1,3,1,[212]
0x2e55fe51cc2144ed4ae6491c092b758b8c8ad1a5,[1537],,1,1,0,0,[]
0xdc42f272a3bb0e10d3d2fba2f750694d6ff25bbf,"[799, 956]","[2528, 1602]",4,2,2,2,"[799, 956]"
0xa4553afcbd85998670f31a1be00e4846524edaa2,[955],,1,1,0,0,[]
0x9502af9674e618d3e209ebeb76843c42f811e378,"[1442, 114]",,2,2,0,0,[]
0xd54fdf2c1a19bb5abe5bd4c32623f0ddd1752709,"[953, 1440]",,2,2,0,0,[]
0x762c0e5ae9d4c726f9ee112cc66ed5f11566a8d0,[1799],,1,1,0,0,[]
0x71a9878438e4f2023362ad85d907d717ae6e6ca5,[1443],,1,1,0,0,[]
0x3af587df25a0546307592d260931b42a0107d874,[951],,1,1,0,0,[]
0x612c3d574236d0da8f2a5d64243a9419982e61ad,[1441],,1,1,0,0,[]
0xf01040a392a63f211a99de380d5c1b665320a863,"[985, 982]","[1768, 730]",4,2,2,2,"[985, 982]"
0x26a60648c215e778e28c6862205101f0a90b4678,"[1800, 1801]",,2,2,0,0,[]
0x349f9aa3285643c8a1dc86abe393adc204807101,"[1802, 1803]",,2,2,0,0,[]
0x6ca4bd52e1f514e1e591063d8938b71a5da0f051,[211],,1,1,0,0,[]
0xb9053087adef9eb7a005dcf5acdd2e7f9b55c523,[981],,1,1,0,0,[]
0xec21352cc39162099e4a8a08d4ec7dd9de38aed0,[983],,1,1,0,0,[]
0x50eba10c6f54a228e022ae5021ddaec2f0dbd3d0,[1217],,1,1,0,0,[]
0x1875b8ef98ae3ba7488b6e01ee40a9d03a9acbc1,[1804],,1,1,0,0,[]
0x56cc548cff2857016aaaa41df346c790cb1d0c81,[262],,1,1,0,0,[]
0xe123775416cc49ef9f15af639a66f9f694d8d347,[1216],[921],2,1,1,1,[1216]
0x9004392c07898d6724d793475c543bc673668c24,[221],[3396],2,1,1,1,[221]
0xfd67f20d46668e25f09c1c2269b21796aa5c1452,[261],,1,1,0,0,[]
0x19f3bca7f5cc83358acedf9e50802a46ed26fbf8,[420],,1,1,0,0,[]
0xeb6c193d288fc8d2766b22a0e393df920313433b,[115],,1,1,0,0,[]
0x148e7c3fc39a385887a7c2e81cc67beb9e1347f1,[726],[2967],2,1,1,1,[726]
0x577630c4bd5a92b64a0f9d49809fea2875edc234,[750],[2315],2,1,1,1,[750]
0xe02585e5164f86ac05b139ca191f5a54d5d440ca,[990],,1,1,0,0,[]
0x2eb3058952728ba943f2b398ea5c238148ca66c2,[976],,1,1,0,0,[]
0x0f924c28480ff77ad01ddb9dfcd2d558dee56f05,[749],,1,1,0,0,[]
0x475356facd4e0d05947a71b89f79805651ad8032,"[1805, 1806]","[2712, 3391]",4,2,2,2,"[1805, 1806]"
0x9dce000eb7f14a56fa08736a5d7e2d37db154ff6,[1218],[731],2,1,1,1,[1218]
0xb6f0f50a084a8fa6c120c3cfa49e873da76d7154,"[287, 122]",[124],3,2,1,1,[287]
0x0c675e3ed1e0ee0fb9ca8098daa043fa03559be5,[1341],,1,1,0,0,[]
0x54ccb99f7695204ebb2b35854374bbbd2530586f,[1807],,1,1,0,0,[]
0x95296ed1391630ce971f02b4a560bc0ff4713a1b,[1808],,1,1,0,0,[]
0x7068cc5190f2b9cd524f9a3e1e4a0b09f63e91fd,[1534],,1,1,0,0,[]
0x82ba7508f7f1995ab1623258d66cb4e2b2b8f467,"[1809, 1810]",,2,2,0,0,[]
0x51672bb6c10ade9fe41e3b7d2e10b9b27b42a8bd,[315],,1,1,0,0,[]
0x03a5a0cf1c08a273484a13808bb1d6e4cf7e5629,[51],[182],2,1,1,1,[51]
0x1923c06227ed072264240aca422056217f04af48,[1346],,1,1,0,0,[]
0xea063b621bf7888c5843fc893537fb092ecf976f,[1342],,1,1,0,0,[]
0x39402e0ad8c8248f5719efa4cd56b940124303c2,[1340],[188],2,1,1,1,[1340]
0xea0e63bff02228ecbdb31939ba23dcd8da8a2679,[1811],,1,1,0,0,[]
0x9d7d086012f6c610efa54de9a6e14ca53629155f,"[1331, 1304, 453]",,3,3,0,0,[]
0x1aac5bf021311bb1621565503a8bc8e39828e760,[1343],[1762],2,1,1,1,[1343]
0x5cd44c624628bdaa4347d7de3abbe93d6507bae2,[1548],[3223],2,1,1,1,[1548]
0x7073e0e2ac3b0cd36e3e1fc682c545fd8ed64848,"[1812, 1813]",,2,2,0,0,[]
0x503cb70aefee1c84e2224be50dfbd80ee3557d4c,"[1538, 584, 581, 273, 583, 330, 331, 332, 561, 557, 559, 560, 563]","[1572, 1573, 1574, 1814, 1576, 1807, 1808, 1809, 1813, 1811]",23,13,10,10,"[1538, 584, 581, 273, 583, 330, 331, 332, 561, 557]"
0x50b922946c86a90be49229e866ca2fbed450a071,[989],[2316],2,1,1,1,[989]
0xfe6dcc38124457b855928eb87bc6628455a615d8,[1549],,1,1,0,0,[]
0x3ae8161d662c6dfb6dff4875e2c16a298a29c527,"[730, 729]",,2,2,0,0,[]
0x21afb352cde0c370c6c9972ed0a446120bead71a,[746],,1,1,0,0,[]
0xfb9608a681b61c903a058d95a13f9173aa707ef5,[735],,1,1,0,0,[]
0x890a157620b9f526b9e6e06b4d2365d734312c1c,[1533],,1,1,0,0,[]
0xe941bbebdcbb79322bd6b8c28cfb3c6cf15ee24a,[1480],,1,1,0,0,[]
0xbc2eb49df3a6e326918c7b92f060720de739d7e3,[1479],,1,1,0,0,[]
0x292d67e5d1c1834bd86d2f0767b01c6f9249dda6,[1550],[3171],2,1,1,1,[1550]
0x28a68f027addbcb2fe03fb948c456daa0e581f5d,[899],[1144],2,1,1,1,[899]
0xe0c2b86cd673fbee8f24d2ed86a34afc060f20eb,[209],,1,1,0,0,[]
0x609eb3c94da5c1c16d4ea314961d1fbce8812e43,[1619],[131],2,1,1,1,[1619]
0x0fb4b080b21f4d95a9d64bb2c488f8e57aab1899,[1352],[1543],2,1,1,1,[1352]
0xd836de82def4f4de5d672d0b86b18d49a330fb30,"[336, 342, 277]",[122],4,3,1,1,[336]
0x522c35deee40ee4cac49f9666768316c68e649d9,[952],,1,1,0,0,[]
0x6c55f38e83b62fb47de8865b3db571df77dcd624,"[276, 747]","[1292, 1539]",4,2,2,2,"[276, 747]"
0x384c03c5a0685a0419dd7f8456a6dca669a56454,[245],,1,1,0,0,[]
0xe2d6fd17f51f6a7897b689064c32954ce3003090,"[1311, 152]",[1545],3,2,1,1,[1311]
0xa998536391b420aa5b47e09c6811a6747b31ffc8,[106],,1,1,0,0,[]
0xa63f3dec58506f43b721025ae9cbad9f4f7c658a,"[160, 903]","[4, 1612]",4,2,2,2,"[160, 903]"
0x1082da916456f4c3d36bb6147ffdedb8ef2fcf57,[161],,1,1,0,0,[]
0x3a0b433cdf858a29f3f31426d14dd5264700bd77,[1815],,1,1,0,0,[]
0x9a59d16e7665c40e60b1a6197193ca0eb44ce434,[52],[1548],2,1,1,1,[52]
0x36c15170088e6867fb2d3b14dd7e05dfdd6d7f0f,[279],[1547],2,1,1,1,[279]
0x524f8ac722dcd12c50499f6a414271a8d71d64d9,[280],[2159],2,1,1,1,[280]
0xf96f4a292dff0863614213c7bb8b6f3f7acef0a0,"[652, 281]",[1540],3,2,1,1,[652]
0xa3b48441db3b00badcc87b2c6aab9198720e4797,"[286, 593, 595, 1541, 327, 1729, 324, 1614]","[1267, 1263, 654, 3319, 1101, 753]",14,8,6,6,"[286, 593, 595, 1541, 327, 1729]"
0xdffc5de7aca1d4d20c9797622237460a526807c6,[1225],"[212, 1384, 1380, 1362]",5,1,4,1,[1225]
0xcad3a4a33f19f51403289f143c97a626df74d52e,[600],,1,1,0,0,[]
0x4784c84f1599c99e078bb5f5bf27397b5506c0e1,[601],[2962],2,1,1,1,[601]
0x8bc98c43ef5c92380f9df28f6e36fa84c52a5ea6,[604],"[2870, 164, 165, 166, 167, 1340]",7,1,6,1,[604]
0xf3315d1cf29a4b0e658b8cc682a3d521ebd95525,[288],[1812],2,1,1,1,[288]
0xfeb3056eb91c8059239b6bb592f84e7b0d555d27,[219],"[1759, 1760]",3,1,2,1,[219]
0x0ada1d0409012e420da25bcd2bef1a240ec4b347,[454],,1,1,0,0,[]
0xd1b3284f1d9e177e8ac121c7ae3fa9c1b557d6ac,[693],[29],2,1,1,1,[693]
0xfc2e9174012740cea8f377e8c30fe96d82781baf,[452],[1339],2,1,1,1,[452]
0xec3881d003397272edaa2d2d6a46e72cb5bc677c,[1817],[1345],2,1,1,1,[1817]
0x7ba0466d68174a8d8959996c4b4455b29a2ce482,"[1617, 607, 334, 612]",,4,4,0,0,[]
0xd12ed87b83363db27b3a7d2fa86bab2c7ead11f3,"[1818, 1819]",,2,2,0,0,[]
0xf63731b2d140f4ab338b971fe6721718c40068d4,[289],,1,1,0,0,[]
0x16c1fdbf064633aee44add10e3bf34cefebbf9f5,[1615],,1,1,0,0,[]
0xaf9b002a8dcf0685eb6bbf9cf3aef6fde03dec96,[781],"[1328, 1356]",3,1,2,1,[781]
0x16c4a918d1f9dee4b16e3462da4a5c00d04b21b9,[341],[316],2,1,1,1,[341]
0xa8ebc0b1f61ae1b08dbe77b9336f47cef0181878,[605],,1,1,0,0,[]
0x2d8a0bfe66e5c456f0de93f620a3b9c3f8b5cb61,[603],"[363, 651]",3,1,2,1,[603]
0xe28a701b941dc57bbd054a90b0a7975231cc9c93,[621],"[2504, 2503]",3,1,2,1,[621]
0x774945f69ee6fbae648a4d479c605d1d09c489f1,[598],,1,1,0,0,[]
0x045c954481d07a7d44807b08ac0d52f0f34ffb98,[596],[1152],2,1,1,1,[596]
0x45181efade2d41e3590e33089a82911bcb1577d2,[599],[551],2,1,1,1,[599]
0xe8127840cbeda5f0fcef3bfdfdff0fdfb7a36eaf,[597],,1,1,0,0,[]
0x0120f57d0423b8c0cb72ddb7797ff40e8bcb74d6,[241],[181],2,1,1,1,[241]
0x69708e4808bb1e1a90d1133f29518da1ada31b30,[1335],[1431],2,1,1,1,[1335]
0x2a62b0b3d84c770d09d8c233a3b6758eebd48a08,[1616],,1,1,0,0,[]
0x29adece4e9806823a5449a221c1144fa9c9de2a8,[611],[315],2,1,1,1,[611]
0x8bce3f1707f2e14c88b454b62dfcaaa910285916,[335],,1,1,0,0,[]
0xe3947664d8e7d1b593a809c789ef638c56dda3e5,[615],[1685],2,1,1,1,[615]
0x01d99e4a766da9531afc913b80fb8847cc7a342d,[1820],,1,1,0,0,[]
0xbeca82c0ca4eed5b27f8ad6741b30aaf9eb9cd33,[1025],,1,1,0,0,[]
0x2c6ab9e18679c07f3bbeb9360a7b5ffa95170301,[1585],,1,1,0,0,[]
0xf5bfee6fba88fc556b9fbe46318b2211a64dd9a4,"[610, 274, 585]",,3,3,0,0,[]
0x0d73c03f80c15b94b161de01a63aae9db3983a51,[613],"[58, 2752]",3,1,2,1,[613]
0xfd37e934a51ad828a2f2efffe2a98454845b54b2,[1824],,1,1,0,0,[]
0x82b4b0f40214503c23d3853c3ca9e551c0e608a2,"[782, 786, 785, 784, 783]","[2352, 2345, 2350, 2309, 2348, 2298, 2351, 2347, 2346, 2297, 2307, 2349, 2305, 2296, 2295, 2308, 2304, 2301, 2303, 2302, 2300, 2299, 2306, 2294, 2292, 2353, 2293, 2286, 2291, 2288, 2289, 2285, 2280, 2279, 2290, 2283, 2282, 3, 2287, 1433, 2281, 2284, 1434, 1432, 1435, 2381, 2378, 2376, 2374, 2370, 2359, 2363, 2369, 2362, 2366, 2356, 2355, 2379, 2375, 2365, 2364, 2382, 2361, 2360, 2358, 2357, 2367, 2371, 2368, 2372, 2373, 2377, 2380]",78,5,73,5,"[782, 786, 785, 784, 783]"
0x9fbc93cdefbd093ea7766460685592a5940f002e,[748],,1,1,0,0,[]
0xce29ac621d9b073fd4ca7eb6848324dfd638850e,[488],,1,1,0,0,[]
0x6754455d516dc87a2dd467cf7e78e1a9492c98c5,[333],,1,1,0,0,[]
0x89a42880d7866bce5e3ef7ec9a869fe57f1cb1b3,[462],,1,1,0,0,[]
0x4175681f23de93a249260ef6a1e47de6b6367ccf,[578],,1,1,0,0,[]
0x916d0526685320dfbf25c375c243cf795b7aa264,[580],,1,1,0,0,[]
0x2b4a3ebb0b5be22e53d058029948d882b4afe27b,[579],,1,1,0,0,[]
0xb34d91978972682032fb2d9ee0924c5869f81b97,[577],,1,1,0,0,[]
0x0dcb4a96a4c860b2f0e43971a74139cb69d13b96,[616],,1,1,0,0,[]
0x0a697fedf4ba2a62b266d82a7006de45a9bfa910,[24],,1,1,0,0,[]
0xbb179f078bac0ff4f181f6e01606ccae883ef74d,[1588],,1,1,0,0,[]
0x5e117276a540dffe52f7406fa453359631b3a6c5,[361],[2702],2,1,1,1,[361]
0x1e3f12536d68060b2ee318636009d028ce4c071e,"[290, 576, 614, 1814]",,4,4,0,0,[]
0x3429f747684766dfc5b9a2fe5b0e35be9a0b605b,[562],,1,1,0,0,[]
0x6a5d5af0e266a24648a9d7e8d388eaec7abd8433,[28],,1,1,0,0,[]
0xdfa4a566939e4d079d3ce5a7d869cc22804c2031,[25],,1,1,0,0,[]
0xe155c40b2aea06f3d9f47cf45fc9d4925a9c2c8a,"[558, 556]","[2073, 1347]",4,2,2,2,"[558, 556]"
0xfdd4c7b8083956c7608b1ebe0425e3b62675b1d3,[275],[2894],2,1,1,1,[275]
0x6c12f884501bd892782f921d2aa0400bae3c92ab,[586],,1,1,0,0,[]
0x8a0dbd3ecd416cfbf5e543977d5ac3130c9838f8,"[590, 587, 263]",,3,3,0,0,[]
0x5a427223d38c1bf40262b8ab7d25c4506e7bf1b3,[594],,1,1,0,0,[]
0xdae4d6f4c40452b67206e444b4fd64d9db3d426e,[588],[602],2,1,1,1,[588]
0x7a0411d0f36465db8be5afde6494b25455e91270,[1621],,1,1,0,0,[]
0xb537395adf639315572470a3bfe220fb0d20b627,[608],[1287],2,1,1,1,[608]
0x49aca0876916de229079ce78a4797bfe0fb728ee,[589],,1,1,0,0,[]
0x4fa3c33531da3f9bbbd69f2ec23663d7d66de043,[954],,1,1,0,0,[]
0xd0ee8efa0f3c3c33e5bcda4ddf55fa71a9be2ce6,[1620],,1,1,0,0,[]
0x31b2f027cc9539a6c9e64342554de39c548b5e53,[592],"[598, 599]",3,1,2,1,[592]
0xccfdb6dec6e98b09e6b760cabd0f27694220fc0d,[602],,1,1,0,0,[]
0x084b7ac80d4cd626db1c2dcc6ec6e932ec6f3bfb,[591],,1,1,0,0,[]
0x07793a62349e333ea65a71b870550001aaa672b7,[732],,1,1,0,0,[]
0xf726cd4171fc91e920f7ff5249588c9613be3c5f,[733],,1,1,0,0,[]
0x413d3bf63d4140a1a2131fbdcac7d6c710a598b9,[53],,1,1,0,0,[]
0x210750b623109d8d0834240e2e125ee4405d1045,[1618],,1,1,0,0,[]
0xee945112d8a1846ade6ae984b007e9839fe4926c,[326],,1,1,0,0,[]
0x1cd15c832da85eada588e9914f5b65e5054845b3,[2],,1,1,0,0,[]
0xbfa7a804e88b4aa5ba133ba63a02bbc518a757bd,"[1826, 1827, 1828, 1829, 1830]","[1078, 1079, 1080, 1081, 1082]",10,5,5,5,"[1826, 1827, 1828, 1829, 1830]"
0x6d50e22cec46d16d6376504669c6d52d609e86e7,[1831],"[1858, 1859]",3,1,2,1,[1831]
0xb6941a32218bd6a34ca3d80b6a9ca20b75e50a6d,"[1832, 1833]",[348],3,2,1,1,[1832]
0x6557dadc6cf2eaf50a48ef607552e799ef18c47b,[1834],,1,1,0,0,[]
0x5b8235604885b9fb34e6dde5d8b47fb92c0371a9,"[1835, 1836, 1837, 1838, 1839, 1840, 1841, 1842, 1843, 1844, 1845, 1846, 1847, 1848, 1849, 1850, 1851, 1852, 1853, 1854, 1855, 1856, 1857, 1858, 1859, 1860, 1861, 1862, 1863, 1864, 1865, 1866, 1867, 1868, 1869, 1870, 1871, 1872, 1873, 1874]",,40,40,0,0,[]
0x225f7d35a72138de376c62ee508e0f842868cb2a,[1875],,1,1,0,0,[]
0xa8c4cb9a481fe65542ee90e379058667210ff90c,"[1876, 1877, 1878, 1879, 1880, 1881, 1882, 1883, 1884, 1885, 1886, 1887, 1888, 1889, 1890, 1891, 1892, 1893, 1894, 1895]",,20,20,0,0,[]
0xb6a46ef97a2082e002087cb1282c94c12b9b3d93,"[1896, 1897, 1898]",,3,3,0,0,[]
0xba713c1effce5a21b2e1ebddc79b7a62a1b8ba37,"[1899, 1900]",,2,2,0,0,[]
0x6828426a646f55cac2807e83478aa1691ad876fe,[1901],,1,1,0,0,[]
0x6051bc0b15403f81f9f019918052a5498a7f856a,[1902],,1,1,0,0,[]
0x511652f5f25f613331cd95e580c1a357146f4af1,[1903],,1,1,0,0,[]
0x528497967730411c6d6cd1f13f6731ed3bda4d15,[1904],,1,1,0,0,[]
0xa4ef5fdec4f58259f065298d3583b5411df8c981,"[1905, 1906]",,2,2,0,0,[]
0xaa06ba6a7dcee3e81f5cabbab7fcc1b9d9cfd4d8,"[1907, 1908, 1909, 1910, 1911, 1912, 1913, 1914, 1915, 1916, 1917, 1918, 1919, 1920, 1921, 1922, 1923, 1924, 1925, 1926, 1927, 1928, 1929, 1930, 1931, 1932, 1933, 1934, 1935, 1936]",,30,30,0,0,[]
0xfff24a5586a9683c64e7fb0f406031b68be6e356,"[1937, 1938, 1939, 1940]",,4,4,0,0,[]
0xba98660fefd278bff047542e28efd44eb8ef65fc,[1941],,1,1,0,0,[]
0x3c494547d0d5ab343fcc094ff21a1ac306b19a9e,"[1942, 1943, 1944, 1945, 1946]",,5,5,0,0,[]
0x468a3cdb8f6b497346b8af64cf21c17078ae0b71,"[1947, 1948]",,2,2,0,0,[]
0x5db80e3d60e969a96fcf726dd2222d96db892d5f,[1949],,1,1,0,0,[]
0x0ea93dcd667e635880ab67e25fd700b80d4446bb,[1950],,1,1,0,0,[]
0xe40314868cc4240ff15f46e7089a032f294f711e,[1951],,1,1,0,0,[]
0xc2378172abdc08e214ac2bcca6c0aa6e9fe746a4,"[1952, 1953, 1954]",,3,3,0,0,[]
0xbb4cb19202af995a43568f87462f7193db693208,[1955],,1,1,0,0,[]
0xda156456f901ef551fbe07a022fd160e106bfc4c,[1956],,1,1,0,0,[]
0x4c9c9606b4a05eab15bfd5529d37901aa92adbaa,"[1957, 1958]",,2,2,0,0,[]
0xcbede5d0149b04b5beb3e705f4aa9f74dd67a683,"[1959, 1960]",,2,2,0,0,[]
0x5c8f0c617d0cdd5d75ec7fe4647cb5466b06082a,"[1961, 1962]",,2,2,0,0,[]
0x7ff0373f706e07ee326d538f6a6b2cf8f7397e77,[1963],,1,1,0,0,[]
0x63ce2838e57a0159416f93fb12dc94ea99209652,[1964],,1,1,0,0,[]
0xb0213db41c17e68fad949139699a6f90b5705211,[1965],,1,1,0,0,[]
0x02538eb9d55966921de92af8932ad06a8f8e7326,"[1966, 1967, 1968, 1969, 1970, 1971, 1972, 1973, 1974, 1975, 1976]",,11,11,0,0,[]
0x4ed4760a09e9adf799528ce457ae5c8876594da5,[1977],,1,1,0,0,[]
0x5b4672cffee5e64a2a7d17c157abdb4edffbe3df,[1978],,1,1,0,0,[]
0x4752bf38a73bdb92d7952caae928330ec3a7f4e1,[1979],,1,1,0,0,[]
0x9ed23025aaab4331fd8157d4e23fd676dc447937,"[1980, 1981]",,2,2,0,0,[]
0x6ff79a4f7d0465f15916aa2197dd47067ce4ab4d,"[1982, 1983]",,2,2,0,0,[]
0x01cc340fa55b6c6f10bcb04dbeb0202a31b07080,"[1984, 1985]",,2,2,0,0,[]
0xc9e3a78dac7e5baee3c280c44f3225e41a41c724,[1986],,1,1,0,0,[]
0xa6446c9d42261507cb33e1508dd8962eea559e39,[1987],,1,1,0,0,[]
0x1406a3103fcf8d7854533ee691e29935bdb49288,[1988],,1,1,0,0,[]
0xe6c97606be089a0455ef944b49588596f62136d3,"[1989, 1990]",,2,2,0,0,[]
0x05ce7f3bd70acf5fb610a88c464359c0df55e187,[1991],,1,1,0,0,[]
0xa7891faf3c25767bc38af9d9f0087e6eb67c3040,[1992],,1,1,0,0,[]
0x1aba978cf66d4bd8ce54ab5e3aaff177ab901fb6,[1993],,1,1,0,0,[]
0x0049665f987361e8f2bee667acf9cea278163425,[1994],,1,1,0,0,[]
0x200998f1c6bb56b100752c9334dd445c7d0740c3,[1995],,1,1,0,0,[]
0xcd372d29c981e3e077b3350511e7053796d89413,[1996],,1,1,0,0,[]
0x9d3e3890bc0c9928fc5063413d79b9f424417bee,"[1997, 1998]",,2,2,0,0,[]
0x6a12b297949eb87e5931c768de0568df66f9755a,[1999],,1,1,0,0,[]
0x3729e2db4ef7af3c32d909983094f48e6841710f,[1572],,1,1,0,0,[]
0x11825767fa3983445df1a4d4fbc494602dec6a6c,"[1570, 1267]",,2,2,0,0,[]
0x30ae0355acc33c01a983af67ad80af5e9b677e32,[1731],[642],2,1,1,1,[1731]
0x012ee90231e54c7c4e0abc0d154b759c2efa7617,[1277],,1,1,0,0,[]
0xde438a305fa86fcbac945367fc4402406542172f,[318],,1,1,0,0,[]
0xd08220b4beb961f14d0fc53533e0f1ec4253341b,[565],[655],2,1,1,1,[565]
0x6e2eb8bce04f519c3b706781c8ecdf4b57229cea,"[582, 1444]","[1331, 1346]",4,2,2,2,"[582, 1444]"
0xa40c199ab02e0d61b285ef7d7048758caad03460,,[940],1,0,1,0,[]
0x142b04a5c9da4878b9924345bb7d940e5a152f0f,,[1001],1,0,1,0,[]
0xaa7158712ea933e6fc03b1a5076d2fda28ee45d0,,[1052],1,0,1,0,[]
0xd1927c49c76d86a9c24f11603cf940b8436ceb37,,[2354],1,0,1,0,[]
0x15b7df6c6dec930e91b172755548d8cb932b0d16,,[1008],1,0,1,0,[]
0x190e7392b70b196ac45e961a68021b979edb804c,,[1314],1,0,1,0,[]
0x9f2301960df3d3c97d891362d716f42e93d35d1e,,"[216, 3217, 3218, 3219, 3220, 3221, 3389]",7,0,7,0,[]
0x119c593a56629700bcf49bf710b082d2efc6c819,,[1283],1,0,1,0,[]
0xbcd38f9b7a5ed6616affc0441a072835839568b4,,"[2003, 1062]",2,0,2,0,[]
0x20bf7dc4b28c1d7e0c0bc8f48d310d724743b9ad,,"[645, 649, 30, 13, 1, 767, 2180, 15, 2473, 848, 2446, 3092]",12,0,12,0,[]
0x1000aa994acc1122d25cf8f3cee4780d0f9210b5,,[1665],1,0,1,0,[]
0xd19601dc9565b80863a6a52b5285ac212d36175c,,"[1673, 1676]",2,0,2,0,[]
0x68894737830b61d32c665fc900758e3fcd446ea2,,[2563],1,0,1,0,[]
0xa4776f227db583dae50d2f71ee6404721ef56770,,[2612],1,0,1,0,[]
0xaa8e273067213ed5481aaed4fc626c0f426d2a22,,[2],1,0,1,0,[]
0x9c99577077ad6f1989dd0447b0f6127fbcfe889d,,"[5, 6, 7, 8, 1796, 1797, 1798, 1799, 1800, 1801]",10,0,10,0,[]
0x574099efc7a64c8a7dc965a22d942c1740158da5,,[9],1,0,1,0,[]
0xc5f6b52bdabce080a68b49e80ea264699c174882,,[14],1,0,1,0,[]
0x4d4f3098667589b3c800aa9abccf7651a2ade3c9,,[17],1,0,1,0,[]
0xe2d9d2c9b333ece773e7c04f54c0024924ca16dc,,"[20, 21, 22, 23, 24]",5,0,5,0,[]
0x6c5cb5265251789a8a84e3e853e8d07a42118bbc,,"[36, 915]",2,0,2,0,[]
0x12505cac560feff75e3fc11022af9ffc91363aaa,,[42],1,0,1,0,[]
0xdf85ca6fd65e4b5a3dfa076b3f585437f3aabd18,,[43],1,0,1,0,[]
0x6cc0098a60c5c2232b024d952cbe045bcef21a57,,"[49, 2768, 2769, 2770, 2963]",5,0,5,0,[]
0x4b6910906f19bcf52fbc34a9d9d48995d716dae5,,"[142, 2172, 2173]",3,0,3,0,[]
0xd873ed7e62aea1a758e047aae4a640c81f8cc8b3,,[163],1,0,1,0,[]
0x88015792b59f7c6237aabea015d318562ae3ed1b,,[202],1,0,1,0,[]
0xf7edba9aadb858545b4df72d750df63d94249ca6,,"[209, 210]",2,0,2,0,[]
0xe3835ac65099adb2b16091049fcf8a222a001d63,,[211],1,0,1,0,[]
0xc03acbcdd69500fdf7ee4a01930ee2a523aa5110,,[213],1,0,1,0,[]
0x05c2fe57f45610eef55ae5855d4e6a1d610cdd25,,"[222, 223]",2,0,2,0,[]
0x42842c35329e504141e482cd0e30884fc5616aac,,"[270, 271, 272]",3,0,3,0,[]
0x19842532539da32c8a33be2e89d25cdc0476a890,,[277],1,0,1,0,[]
0x2ef809e0d0520ab97b081aa1da6d50c6552a7d66,,"[278, 279, 284, 285, 286]",5,0,5,0,[]
0x02e89a25ce2b7a57bbc6d82e09b613fe8242644a,,[283],1,0,1,0,[]
0x60fca52e3ad3648b952d13b962f9be455d77d698,,"[288, 289]",2,0,2,0,[]
0x32279c896d354c3dbb1089d1c9e2688df3add6a9,,[290],1,0,1,0,[]
0xc27729578f8bde3469d410064b3cfaafde8a93d8,,"[291, 292, 367, 368, 369, 370]",6,0,6,0,[]
0x62f97b2177d84ea2dc43113b37e1af00efd4a0e9,,"[317, 318, 319]",3,0,3,0,[]
0x03828723354b2d13ebca5a48449e585debdee354,,"[339, 340]",2,0,2,0,[]
0x19102de1e34dc6416799dd83bf24af8f7f12a40e,,"[341, 366]",2,0,2,0,[]
0x4ded43fb6b3838ec0b5080550025864c24165c02,,"[342, 1874, 1875]",3,0,3,0,[]
0xd235310a6fa88c0958e30f011f56244105856fdf,,"[364, 365]",2,0,2,0,[]
0x751b5e8b8846e731bf348575d56295181c7bef18,,"[371, 372, 373]",3,0,3,0,[]
0xa6c82f8e118ed5cbefbf6977996e35e2232f410d,,[384],1,0,1,0,[]
0xf00cae475887abbd314fc6922c041bd7553670c4,,[418],1,0,1,0,[]
0x213c24974839ed9e5eeb2e3e6a750f11019ecf67,,"[448, 449, 930, 931, 932]",5,0,5,0,[]
0xb4a370a631f6d9b2d9138c8a9c870a926b542108,,[454],1,0,1,0,[]
0x1790a77f35669d4dbfb0fb586669b98b7c92ed5c,,"[457, 860, 1260]",3,0,3,0,[]
0x4ef7f202ff0948ad76b707e45bab21c479244bca,,"[461, 462, 463, 464, 465, 466, 467, 468, 469, 470]",10,0,10,0,[]
0xb84882f8e6c374efa90e28e1cdd7a574213b70de,,"[496, 1424]",2,0,2,0,[]
0xab5a3922bd13b7c1cdef6685ddf1a3e15e3f9409,,[501],1,0,1,0,[]
0xa05e2b601fd140a3ad649f75ccfdbd205db1e197,,[511],1,0,1,0,[]
0x85ebfa48919036580f3a16a2c6b3ffa7f39516a7,,"[545, 546]",2,0,2,0,[]
0x9438578efdf34c773963c0c43b5dda28fb6b11a5,,[560],1,0,1,0,[]
0x4ee7b99fd34a89bca03a73bf1d643ea3d15cafe4,,[561],1,0,1,0,[]
0x1c9de65bc743bdc17628fb9fcae49294c2ecadc5,,"[583, 728, 727]",3,0,3,0,[]
0xc8f93f7746113f9173fdc205efa61a30ee1fec16,,[584],1,0,1,0,[]
0x1fb3698ef51c38b4ece48628add30f0c5dcdb28a,,[585],1,0,1,0,[]
0xd358c5c2f92282697951f17b780c02d710c7aedc,,[588],1,0,1,0,[]
0x0f3189421e5af810135f07301b41e4b1fb0315df,,"[589, 590, 591]",3,0,3,0,[]
0xa04d3135f76103b3b0b9c90bae5bf66b7d673290,,"[593, 594]",2,0,2,0,[]
0x9dfa68e2b9c9cc6ddcdfdbe91a0dddb8556c76ae,,"[595, 603]",2,0,2,0,[]
0x6d08afbe8a516e60353ae1a7019a7e6a117f9b17,,"[600, 601]",2,0,2,0,[]
0x13a1dfe3a20e74c3d780045163dfd96e9d441e58,,"[604, 605]",2,0,2,0,[]
0xdc1e5e4b8adacb60dc1726a66885cb3343eb654d,,"[606, 607]",2,0,2,0,[]
0xd0ab24b50ff0429ee557047661fa3a1409307946,,[608],1,0,1,0,[]
0x350ea526765ad98ce5f65a590c7a801ab5bc1872,,[609],1,0,1,0,[]
0xdcd135e958ae64092a709dfffa35e49f2370a09b,,"[610, 3091]",2,0,2,0,[]
0x1d1473c50fd1b266a2f304f3034814aa978d8d84,,"[611, 612, 613, 614, 615, 616, 617, 618, 619, 620, 621, 622, 623, 624, 625, 626, 627]",17,0,17,0,[]
0xd2c65302e83be13b6b1242f552f1647edb35c0e4,,"[630, 628, 629]",3,0,3,0,[]
0x1d3fde24c3af13adec826e9292e29e8d197fabe0,,[631],1,0,1,0,[]
0x8d577cb8964e65260bcd53011da31ae0215f1efa,,"[638, 639]",2,0,2,0,[]
0xf329d3d60678c5c088dd993d3327b15597632695,,[641],1,0,1,0,[]
0x99c90e9c60d773a8692aecc2f71fea836132c9e4,,[643],1,0,1,0,[]
0xbd3f9dac2bb7c766a0a017a32057b31d897e1b56,,[644],1,0,1,0,[]
0x6612e2e329d127c02982fafd5f8a069164a7e306,,[656],1,0,1,0,[]
0xcfcfc5d30c0be22e3b8a5eea19398fe6b53daedd,,"[714, 715, 716, 717, 718, 719, 720, 721, 722, 723, 2448, 2449, 2450, 2451, 2452, 2453, 2454, 2455, 2456, 2457, 2458, 2459, 2460, 2461, 2462, 709, 710, 711, 712]",29,0,29,0,[]
0x7c74385d9d4f155abbb600e72a56339769750262,,[724],1,0,1,0,[]
0x38cda4a217a92bbe16b65130c9c2cdb2440532b8,,[725],1,0,1,0,[]
0x62ca087db0f4ef01992662102a5f1badf2c6f022,,"[739, 740]",2,0,2,0,[]
0x4492b97bf6a61f7c4a7c75f808f9634308622b35,,"[741, 742, 743, 744, 745]",5,0,5,0,[]
0x37f22cbf1061bdf9fc000912f7b7340236b04928,,[747],1,0,1,0,[]
0x9e223efb30826c6ef07e2f81ad907cacf5311454,,[752],1,0,1,0,[]
0x695cfd6ccd183e726762b5e91b608de2b96f4531,,[754],1,0,1,0,[]
0x40db8365d1252bcb06598927698238a99d39228e,,"[758, 759, 760, 761, 762]",5,0,5,0,[]
0x52ccf016b4d3532a46602ea4eaacdfd4057816e4,,"[755, 756]",2,0,2,0,[]
0x2115d392e163306cb32ae4a9867601159dcd2854,,[596],1,0,1,0,[]
0x096b00652264e5f365530303604125ab3aed2f6e,,[765],1,0,1,0,[]
0xc58081ecd67949f8aceb1630356551a79dc53202,,[766],1,0,1,0,[]
0xa6e657676a9cf8e80fbe307a2f9709cea68dd8ad,,[829],1,0,1,0,[]
0x20277182b1629dd1361809de3539b26b652863e4,,"[2742, 2743, 839, 1181]",4,0,4,0,[]
0xff4d9489ecf46358835dbab3d5ab395344750733,,"[840, 861]",2,0,2,0,[]
0x47b3a74eda0042bbbd4c1a08c748171004233972,,[856],1,0,1,0,[]
0xda8733148ec2693cd115cc883ead1442b6c417ee,,[863],1,0,1,0,[]
0xf943588f6d428deacddffa6e5c1d8a938e53840e,,"[894, 895]",2,0,2,0,[]
0xef3d3d261b1dd1cd1306815a3f3c8369a6340a52,,[901],1,0,1,0,[]
0x2d5b39494642410d1474bde5fbc9f37b24c3b297,,"[902, 903]",2,0,2,0,[]
0x4e1076f4bfa971b6eed1d03bed962e0b927016f7,,"[1127, 1128, 1129, 1130, 1131, 905, 906]",7,0,7,0,[]
0xdb2fe32c158018cb2bb81727900e053eca4a7b85,,[907],1,0,1,0,[]
0xfaf26dcb409317e39b5b048657327eeddbab3261,,[911],1,0,1,0,[]
0xd491ae8324015db92065d142be6c084de375cd7d,,[912],1,0,1,0,[]
0x0b5bd6934b220e931b768831d0620ba56093485a,,[913],1,0,1,0,[]
0x11319664170552891f3ab1a589d3ad4e41a51d8d,,"[922, 923]",2,0,2,0,[]
0x0b916d3cc45bbd7bea80e17cde3f40f9e9c7f727,,"[924, 925]",2,0,2,0,[]
0x79bb8b00fa2410ed6f1f6961369403cf308b50d9,,"[926, 935, 938]",3,0,3,0,[]
0xdf0d86286b13cf5a2013197a1d62a269eea895bb,,[927],1,0,1,0,[]
0x17cbd1a240c173074159aa91dae84dc6837138cf,,"[928, 3192]",2,0,2,0,[]
0x7cf0b9562c49cff802d81b06c318ea7777e10910,,[929],1,0,1,0,[]
0xd00bd3f9e23c2c30920358e5c1e73ab5ef26f197,,[934],1,0,1,0,[]
0x8c05776efb1f4692164f5d6aff986b39bf5f4651,,"[941, 942]",2,0,2,0,[]
0x3c895a8efb5ca356a1242935b1a4b29d4765413c,,"[1184, 948]",2,0,2,0,[]
0x5b6b4af06798a8c85e8c5effd69b112623e97fd3,,"[949, 950, 951, 952, 953, 1679]",6,0,6,0,[]
0x7efcded5326a78367598cafca4bc0fefcf262139,,[989],1,0,1,0,[]
0x566742afa3e8dd6ed926415dd3d5b9a72aac4b42,,"[990, 991]",2,0,2,0,[]
0x15dfe1f912e7f157dd1e6f9e32ccf4406931de23,,[992],1,0,1,0,[]
0x9d0591fcec26c86e188db6a2d6a0737be5f44419,,"[993, 994, 995, 996, 997]",5,0,5,0,[]
0x875e277fa6995b47ffd4e5d17fd30a077b524200,,[218],1,0,1,0,[]
0x61755a08bac32243d3bac3e0bdf1fa2b66628210,,[1004],1,0,1,0,[]
0x291ce60d3120999714e4a791dd0250fe07e9390b,,[1005],1,0,1,0,[]
0x5cb0cf1f9de127ec04af8cdd8249cda2214a826d,,"[1012, 1013]",2,0,2,0,[]
0x0c6dc4f3851596385ad5b4dd7fef42680023685d,,[1017],1,0,1,0,[]
0x7ab3285cea436ae25a6fd07f14843a08445538c1,,[1051],1,0,1,0,[]
0x979ce5ff8d5c8efed537514b207600a59729f9b3,,"[1053, 1489, 1490, 1491]",4,0,4,0,[]
0xbee00976c702bfda654d108e8cd63ae8a4c541cf,,"[1054, 1055]",2,0,2,0,[]
0x988fd8b79c817d0bc21318c73046fd8609f8b2c1,,[1077],1,0,1,0,[]
0x1f82c0cd589a85dddcbc657cbe887af660374e26,,[1083],1,0,1,0,[]
0x231b8b1f054b695a76c8172acbb145d382ae0963,,[1084],1,0,1,0,[]
0x5777eb92870c1af7a4e97f9aa4657034b36a3ba5,,"[1086, 1087, 1088, 1089]",4,0,4,0,[]
0x79bd61d2bf62974207b9eacc09125e5699603d55,,"[1123, 1124]",2,0,2,0,[]
0x5ecf57ca9877f34892d50274c02749afedbab5cd,,[1125],1,0,1,0,[]
0x9912129a59b64cba413f55430b532d018b780f3b,,[1136],1,0,1,0,[]
0xba2bd3dd6e96a5937d93f814d4f291d3f11ebe31,,[1171],1,0,1,0,[]
0x2443f245944e7333208b90b540a975da83893332,,"[2679, 2681, 1172, 1771, 1772, 1773]",6,0,6,0,[]
0x6b76ad335eb0061b4d8e7a9cb22cf56111ec7e3a,,"[1175, 1176, 1177, 1178]",4,0,4,0,[]
0x60fcc024a1aa8a958a167317a1e8d2698bfd8a9b,,[1182],1,0,1,0,[]
0x2a19465f5a741888a23a0bf541fc287396cdc385,,[1185],1,0,1,0,[]
0xa58e6319f9088ebc493abac2767beb24469066ab,,"[1186, 1240]",2,0,2,0,[]
0x14e61936f77c46399d0f6ad5f223ef9b4c471318,,"[1188, 1189, 1190]",3,0,3,0,[]
0x86966ade9f0cde402ae8f774c3a7a5423beeab89,,"[1191, 1192, 1193, 1194, 1195, 1196, 1197, 1198, 1199, 1200]",10,0,10,0,[]
0x3701afb3a6550c48306863080fbc9f9e2ec41a43,,[1245],1,0,1,0,[]
0x3d319ad11b62a7e178f835734e10643962a18e8a,,"[1246, 2344]",2,0,2,0,[]
0x4376c9d7ffba076514cd5cde798d19752c3b4890,,[1247],1,0,1,0,[]
0x0408d58135fff2c7af1efcf374f6f8fbeafbfb7f,,[1248],1,0,1,0,[]
0x6870b0b730574a8048711c9dfc7fa8b2bae1443d,,[1249],1,0,1,0,[]
0x82dc9e4da0bec1d6b4e8f2c56f2800b74f2fe183,,[1250],1,0,1,0,[]
0x2a773923024d19031f45d159d79b98b0a4873110,,"[1257, 2581, 2582, 2583]",4,0,4,0,[]
0xd9b675e146b039aa58f8137e5cc05a53bd4eebf0,,"[1261, 1485, 1645, 1646, 1872]",5,0,5,0,[]
0x507ece80856dd2b61e466e3d418677850ffbf75a,,[1266],1,0,1,0,[]
0xa7a2a06fc79a31bfea2d3b2a7c69c411d30d3e96,,"[1272, 1273, 1274, 1275, 1276]",5,0,5,0,[]
0xa457b547e17b932f3560275334652751ceda726b,,[1277],1,0,1,0,[]
0x338f6f7974d0b6620c73c3b008be41533704b3f2,,[1282],1,0,1,0,[]
0x9323e2f6d6db4d485310b697a3aad1deecefec3a,,[1284],1,0,1,0,[]
0x6e5a596f2d50b52f1438d6dd6b79bb96db277b81,,"[1305, 3088, 3089, 3090, 3311, 3312, 3313]",7,0,7,0,[]
0x6929ea128bf19adfe122f54550b112250d68f45f,,[1322],1,0,1,0,[]
0xc2e1f7dec9c16dd74b82a131ef4d1beb1f4b9016,,[1325],1,0,1,0,[]
0x4e848b560ad09a55250211bbb1f108b64ffc393c,,[1377],1,0,1,0,[]
0xca4b3ba117923eb7eebb9efde4f69edb2c0de59b,,[1420],1,0,1,0,[]
0x03d84816373924af164218ae9bb6e10e09e9e0e7,,[1423],1,0,1,0,[]
0x9e106696b640093118527edda18b24b601a7eb60,,[1428],1,0,1,0,[]
0x31c8aa19552a262616cb75c1cb881031fdd3dc92,,"[1430, 2675]",2,0,2,0,[]
0x4e65895da5c16a171c9b97f640c34703abc5a27f,,[1468],1,0,1,0,[]
0x5b9db70f7ec4591073894403c9a66ab3c031af58,,"[1470, 1469]",2,0,2,0,[]
0x2eb96f3453c00517ef534aa172a18b385ecff9a6,,[1472],1,0,1,0,[]
0x3ab3129c10dcf6e2e9ba58c63ba93edc819e7a9e,,"[1473, 1474, 1475, 1476, 1477, 1478, 1479, 1480, 1481]",9,0,9,0,[]
0xbebf76cbfc4602a5a786f9f993b9e589059948a3,,"[1482, 3411, 3412, 3413]",4,0,4,0,[]
0x3473cbc7666f20197eec037ad65383c59f9b4887,,[1508],1,0,1,0,[]
0x668cd1afdff3270b1c4f1c88d099d197b3f0c822,,[1509],1,0,1,0,[]
0x5f1c74f70d9163079bcaeb3ae76bda1f5e45e9e2,,[1510],1,0,1,0,[]
0x09b198331dcec39af3d305dc5b23a87971eb044f,,"[3194, 3195, 3196]",3,0,3,0,[]
0x1b24923b07a316ca09db5a4fba3bacba3eb7456e,,"[1512, 1513, 1514]",3,0,3,0,[]
0xff37c2d299c5070db5764cd03b5ccf64081c4c58,,[1515],1,0,1,0,[]
0xb19bdd1045258520241dec0edfc1b59177d2c0c2,,[1516],1,0,1,0,[]
0xa1f44435a40c23f47bfe203dd35c706118ba91a7,,[1528],1,0,1,0,[]
0x4ed6f3ab92ab303b958d2e18463e0d9a22a168d1,,"[1529, 1530, 1531]",3,0,3,0,[]
0xcf53d2ca17c9c2fbb27ddc71db19da5a34989317,,[1532],1,0,1,0,[]
0x0036491737a27a0b7528e06e021c23e1d76b00ae,,[1533],1,0,1,0,[]
0xa4aea6e3fc603573adb2310307b1fd14f37ac986,,[1549],1,0,1,0,[]
0x5d541f4c1ae6763020c6c9404d62a9bd697d42a5,,[1550],1,0,1,0,[]
0xcbfd274220796cdf913f3f205ac432eb4c3ef21b,,[1551],1,0,1,0,[]
0x80c81a3a714e0cfeeaced8527025809ee76fb7e4,,[1552],1,0,1,0,[]
0xb7a4da20c01b5870552f02defe7d22dcb4765ad9,,"[1586, 1587, 1885, 2060, 2636]",5,0,5,0,[]
0xa67a73a7471209cd7306f1c24af97820093e68cb,,[1588],1,0,1,0,[]
0x7247c949cd95271259bbe245ab814360d410cedf,,[1589],1,0,1,0,[]
0xdb020f7aed2159b888f31756c8da32a09334cd4b,,"[1590, 1591, 1592]",3,0,3,0,[]
0xb0b8299609c772a04b600276edafbdf18d4138b5,,[1593],1,0,1,0,[]
0xf2a94d450b379d56b92a890b205bab8e424243b9,,"[1595, 1596]",2,0,2,0,[]
0xd2842e487932468033b373d971588054991d4e15,,[1597],1,0,1,0,[]
0x7cf54c0b4b5c7c4c2f468c742991fee8809f2b08,,[1613],1,0,1,0,[]
0xa619239ce0fdcced2b840adc11f85e61f3d20dbc,,[1614],1,0,1,0,[]
0xe86fdb50d31d5832828224b76afc59425c400cfc,,[1621],1,0,1,0,[]
0x2b139887ddff3dc893f1722cb2eafa77cfc41395,,"[1626, 2415, 2416, 1700]",4,0,4,0,[]
0x40a80422da5bd9052e2adef135a497cbb80c2589,,"[1628, 3251]",2,0,2,0,[]
0x5d2c3037178d0938ae19129974e0a4d4a648b491,,"[1631, 1632, 1633, 1634, 1635, 1909, 1910, 1911, 1912, 1913, 1914, 1915, 1916, 1917, 1918, 1919, 1920, 1921, 1922, 1923, 1924, 1925, 1926, 1927, 1928, 1929, 1930, 1931, 1932, 1933, 1934, 1935, 1936, 1937, 1938, 1939, 1940, 1941, 1942, 1943, 1944, 1945, 1946, 1947, 1948, 1949, 1950, 1951, 1952, 1953, 1954, 1955, 1956, 1957, 1958, 1959]",56,0,56,0,[]
0x1b7eb8f4d14078fc5fe62975965236e7b44dc8dd,,[1636],1,0,1,0,[]
0x43cbd33dc1efbe4b954316f7905d39859744ba2d,,[1644],1,0,1,0,[]
0xf47e6b1ebf3debef4faea6733cbbe0f88cbf29df,,"[1650, 1651]",2,0,2,0,[]
0xdf2acd6bcd758f0f2c05a173925eb366ded2813b,,[1652],1,0,1,0,[]
0x2e619576c617138a74bd85f7b00162d6fd480f3f,,[1653],1,0,1,0,[]
0xc836fd88e94114b66becbc4ba406e432b192c885,,[1654],1,0,1,0,[]
0x37820ffe1e83e28e730158619fc9c5aa181ca90d,,[1655],1,0,1,0,[]
0xc535714a177c0a77664794cd1ac76283c2437976,,"[1656, 2463]",2,0,2,0,[]
0x20028d74f9d6bf748d108df8fe2d64f052f72865,,"[1657, 1658, 1659]",3,0,3,0,[]
0x40d16ae60e36dd989bf856ce366cf997fcd8ee31,,[1660],1,0,1,0,[]
0xa1e86b83e3a76778c3eed06d15fbb4eb874130b4,,[1661],1,0,1,0,[]
0xd9254c4a62154f7d2ba05767b266722ff52cb084,,[1662],1,0,1,0,[]
0xb6da1080a28348bebb4313798601378fc76a9e52,,[1664],1,0,1,0,[]
0x45abaec3ac2da4db96855ad722be05089ade1ea5,,[1715],1,0,1,0,[]
0x3a64d607abebaf681d7797f618b9db2243eabd48,,[1716],1,0,1,0,[]
0xfafa0f992568c1311c25082978622e127d792d06,,"[1719, 3410]",2,0,2,0,[]
0x46830a9baedf2953c01b212e776c396f14b211a7,,[1720],1,0,1,0,[]
0xd4226e115d04defd51eb31316e6f14f7c69f0da6,,[1721],1,0,1,0,[]
0x9da1d761f43ebf660a07dd7e52e2685839b86ef0,,"[1722, 1723, 1724, 1725, 1726, 1727, 1728, 3048, 3049, 3050, 3051, 3052, 3053, 3054]",14,0,14,0,[]
0x8caf69af0af876a23809d3ac96a4d451480f5eda,,[1729],1,0,1,0,[]
0x8dee914e007e1ab60c2bb05650b16f5e1d85bd2f,,[1730],1,0,1,0,[]
0xc160bc628edff20ba8ae6acb3afb6c4b89c1252e,,[1731],1,0,1,0,[]
0x5c1f0b67c6a7561c7d11b72cd1add95e6f0fdad4,,"[1732, 1733]",2,0,2,0,[]
0x683d7881963b267d9397098b229f58df92e00123,,[1640],1,0,1,0,[]
0x5a256414991ab0bfcea1b7c17574aaf1672a4309,,"[1735, 1737]",2,0,2,0,[]
0x5ac4a971e1eb953932294f53d465bbcf0fc45985,,[1740],1,0,1,0,[]
0xe68a1aa74ffa63785f141ea35f87758752f9fa9a,,"[1741, 2117, 2118, 2119, 2120, 2121]",6,0,6,0,[]
0x64582032221c462c2e99cc9c29b9f5b0a17f5889,,"[1748, 1868]",2,0,2,0,[]
0xc6881beeac05ea833a25afd0de24c9df35f4994f,,[2985],1,0,1,0,[]
0x3f46b9484cbda5ca45f01715894f9e1e884bc224,,"[1756, 1780]",2,0,2,0,[]
0x454f09b8301ea53d4b209956d46d94490663536c,,"[1757, 1765, 2230]",3,0,3,0,[]
0xc370759ec64d44505f1c699a483e1171cc620d50,,[1763],1,0,1,0,[]
0x665334136704f98c5d82f83a02c576fac501d493,,[1766],1,0,1,0,[]
0x7401fe598233e5e0a185fe46179b8ace880e88c6,,"[1767, 1788]",2,0,2,0,[]
0xabb274c61aed5cedad856540710e80259a08397a,,[1770],1,0,1,0,[]
0x48b172a8085be7bcfc6a21abdf408777a9839468,,"[1776, 1784]",2,0,2,0,[]
0x288d7be6581266038136bb64037c87d7a01c2e3d,,[1781],1,0,1,0,[]
0x31a104edd3b5d4e94b71ebf949bf5e2e6e3e9bfd,,"[1782, 1783]",2,0,2,0,[]
0x0ffa5165c29304d18dc244f653a9b3104e90eca7,,[1789],1,0,1,0,[]
0x634a88e5f1a078ecfab528dd4eeb3011f24e0e32,,[1790],1,0,1,0,[]
0xafc23ef8fc3cf84a8436386e65fe07f79b36d3e3,,[1791],1,0,1,0,[]
0x51e6b1df2d8c19c5de61205521db5a1c8751d8e7,,"[1793, 1795, 3036, 3079, 3329]",5,0,5,0,[]
0xbe833bd6a80c7987448ec97578b30ea499308d43,,[1794],1,0,1,0,[]
0x5187b54fc9f3c2941580a5eb63cf0c8069aad947,,[1806],1,0,1,0,[]
0x1946ffe540f83ed6fdfecc24a22e3194b05b623a,,[1817],1,0,1,0,[]
0x0972de6eea668bf6b507219e8cdc368fb535a7b5,,"[1818, 748]",2,0,2,0,[]
0x63bba92c3693cb21ed97d1b1e84ee0cc47fef415,,[1852],1,0,1,0,[]
0xde9a5c18c3116978aba9ecd834d4bd8556134870,,"[1853, 1854, 1855, 1856, 1857]",5,0,5,0,[]
0x11300251b903ba70f51262f3e49aa7c22f81e1b2,,"[1860, 1861, 1862, 1863, 1864]",5,0,5,0,[]
0x74c2e454c51c092f1d9beab9fa82068e1af9c81a,,"[1866, 1867]",2,0,2,0,[]
0x75764c2641e567a0b13999394446ce6e50cea2b0,,[1870],1,0,1,0,[]
0x60fc92d44cc80a1a2c965c8bdb01165155fc5e3d,,[1871],1,0,1,0,[]
0x6e966e6b682af8af21e7fd3134c73f369b602094,,"[1873, 1876, 2746]",3,0,3,0,[]
0x994d0c5e289c9750849b916cd4961e1e7ddb451e,,[1877],1,0,1,0,[]
0x2bd4527c6e050aa188bd6781c8ba2f6d3bb356bf,,[1880],1,0,1,0,[]
0x5d6c5f571fc77d9b433eae4c9b8a652cfff4187b,,[1882],1,0,1,0,[]
0xce6a4e2fa54f91f765c1736a2d76641e6cf891b0,,[1883],1,0,1,0,[]
0xf9942690cdcda2d3305c09d7f4e2c0976e32f459,,[2754],1,0,1,0,[]
0xcd2e60153e8aef537fbd78a4d351aac3f16b63bd,,[1886],1,0,1,0,[]
0x37796f0c377fead78f7acd15b693f5d302648e06,,"[1887, 2216, 2226, 2227, 2229, 2228]",6,0,6,0,[]
0x3df89a3a7a94e1d36ca559587dbc517dcf5301f5,,[1888],1,0,1,0,[]
0x5d91c94fd64a08f9b9812c22f4da940b8ceda4ee,,[1889],1,0,1,0,[]
0xd4d703d54d059fce038a6fc0ca14e3dfbf9870d7,,[1893],1,0,1,0,[]
0x004782735748e711046ba6c0d1ccf1d15f3585b2,,"[1894, 1895]",2,0,2,0,[]
0xf58886c5a06873357e946e75a4a7e3051a1f061a,,[1898],1,0,1,0,[]
0xea7dfc4139f4a9d34d69c5cf8b77441f4c40db29,,[1899],1,0,1,0,[]
0x82cb6a4eda3bd4e9b5a8bb89c1cd127af79590d3,,"[1900, 1901, 1902]",3,0,3,0,[]
0x7fdc9b2c0161c9f8ce14619b044662895c30a648,,"[1904, 1905]",2,0,2,0,[]
0x6143c0f386b7fe438c300002b6d31943ff4261dd,,[1906],1,0,1,0,[]
0x0b9abda39bdf6e6d506e95aa0f4f300409df3562,,[1907],1,0,1,0,[]
0x153dd8adc32531e2d25ebc89b6df80e2950f1879,,"[1908, 2683]",2,0,2,0,[]
0xe6f3b4284f949750e9ae21aba7821f69202e1504,,[1964],1,0,1,0,[]
0x20b0d085bed79697ce579a45d108f992bc52b334,,"[1965, 1971]",2,0,2,0,[]
0x4ce0606f1e82dc22cf864f5960f6c254e6259721,,"[1966, 1967, 1968, 1975, 1976, 1977, 1978]",7,0,7,0,[]
0xd803633480e7ee47403a80fcb7d3bfb8fd6d601f,,[1969],1,0,1,0,[]
0xeddb00d08022f282a0179cb4c35697f50ef3b138,,[1970],1,0,1,0,[]
0xed5cd0f435cc7fdede713fc7dc909c8c5ad85458,,"[1972, 1973, 1974, 3352, 3353, 3354]",6,0,6,0,[]
0x1beba695fee6dae16ac8a3af316689faede916c7,,[1999],1,0,1,0,[]
0x9f2f721367d4c8c1a04c54c0a67a0352bde259a0,,[2001],1,0,1,0,[]
0x6addd8acdd75189b33917dd012ae39cf49192707,,[2004],1,0,1,0,[]
0xaf23a5074a51d564d750d7acbeb4bb1b5e57d06b,,[2005],1,0,1,0,[]
0x375158ecb7b0cb43c959920d6f34401b57c41b37,,"[2007, 2008]",2,0,2,0,[]
0x37af6b3cdc6fc632ee700b936c7f8d8d1b204c62,,"[2009, 2010]",2,0,2,0,[]
0xccc8530c0f21f8a3eeb247d183a2f6c23cd96218,,"[2017, 2018]",2,0,2,0,[]
0x621e8a31263d5a23967b49aabf701790a1fed21c,,[2023],1,0,1,0,[]
0x3dfb6f96d18db917eef378d17aa3a4c899b1b9ff,,[2024],1,0,1,0,[]
0xabb955b2d0221c1e21bc0a3e35a69bf0266cea4b,,[2035],1,0,1,0,[]
0xa6c2913895a44815967c40d74fb729fd94572688,,"[2036, 2037, 2040, 2041, 2042, 2043, 2044, 2045, 2046, 2047, 2048, 2049, 2050, 2051, 2052, 2053, 2054, 2055, 2056, 2057]",20,0,20,0,[]
0xe3852d7d37a9bb2d18eb6463f061b7425a8649a1,,"[2038, 2039]",2,0,2,0,[]
0x0ba3fcefc25ce02b35a8ba65af750ab806243ffc,,[2058],1,0,1,0,[]
0x93cbd431e54b8da613bfd7636fe4d878fa309756,,[2074],1,0,1,0,[]
0x08d2a85aed9f1c17b22bdafbc3fdf6b5f1dabce7,,"[2075, 2076, 2077]",3,0,3,0,[]
0x7c4ffbbe9ba9c328340bdca7fcc595c3930e9e86,,[2078],1,0,1,0,[]
0xebccb07224231d2c7698f51d7bb0185ade44f30a,,[597],1,0,1,0,[]
0xfe2575c6402e56fa977651ea30bbfa0d3b4ae578,,[2079],1,0,1,0,[]
0x98deda8a2a5862dfa4173e0a4d32a78e6bbc18dd,,[2080],1,0,1,0,[]
0x050428dbfe10d86c49e56ba40c1ab38fbd2b459f,,[2107],1,0,1,0,[]
0x37b6de3065f115e9986c7fc14a3be0bfc68ea8f3,,[2113],1,0,1,0,[]
0x51da7ce52b86b37562ba8c53ed8ad08c4a90c0e9,,[2122],1,0,1,0,[]
0xac6c5b9ff76d93964891e85578ec4fcdf4d97839,,[2127],1,0,1,0,[]
0x6c79e660fdaca8b1c00c002d53247154016a8ce1,,[2128],1,0,1,0,[]
0x84b396fe345e7ee967b9efecdf922828f205bd0e,,[2130],1,0,1,0,[]
0xd06322b04eb7cd49e810bb1eac57ffa5225e955c,,[2168],1,0,1,0,[]
0xbfcff3aa2579219ea47bbdc783d3e5afb2174895,,"[2169, 2170, 2171]",3,0,3,0,[]
0xb7fa26880d26fe8d1a9430dca09f6d893943ded3,,"[2174, 2175, 2176, 2177, 2178]",5,0,5,0,[]
0x21d033c6b30febcafb9f2871553e3dd62b24d0ea,,"[2213, 2310, 2343]",3,0,3,0,[]
0xcc0a0e723e6bd64df9edf9fac93175a0cc0d8ab9,,[2218],1,0,1,0,[]
0xcb0b359327b57a9e2d7e8c6483d5a3c5649b8ba2,,"[2219, 2220, 2221, 2222, 2223]",5,0,5,0,[]
0x4f89186cf62a9b81e24479360daa1017afd27c04,,"[2231, 2232, 2233]",3,0,3,0,[]
0x0e63db7066fa5c8b001dc43530b3ef6cd1dab7be,,"[2235, 2236, 2237]",3,0,3,0,[]
0xf049ee7639f2a0069dd52305ca46d8478081b114,,"[2238, 2239, 2243, 2274]",4,0,4,0,[]
0x84c6cf0296bfcf14460bd21463fcaf2bade1f7e8,,[2311],1,0,1,0,[]
0x9cd388047d87cc395565866f30102210edbcda88,,[2313],1,0,1,0,[]
0xcc840ef3e587a9b8324a57494e3a95f9f91d1ae5,,[2314],1,0,1,0,[]
0xc8f466030e4d8ae816a4e5171353aedb3844b442,,[2342],1,0,1,0,[]
0x870bc870f1cf4136b0881406f78c6ba2669a4ce0,,"[2390, 2391, 2392]",3,0,3,0,[]
0xf75f688d9f20c4adc2e05b52d2826ab4fb7e5f33,,[2393],1,0,1,0,[]
0x70e79e22e1b78d52a8d41c5c01c1a58b9f64c944,,"[2394, 2395]",2,0,2,0,[]
0xf8b2da72d42f642bb935a717b88414deb6bf7ca9,,[2396],1,0,1,0,[]
0x048fef33688221360de644c2050a98930f4bbe4d,,[2417],1,0,1,0,[]
0x99115ad7fae2252c946548d13cdafd945028c2fb,,[2418],1,0,1,0,[]
0x392339cf6125b0fecd97eec0643ef032dabdf771,,[2419],1,0,1,0,[]
0x64d99d49c6fb5997dd3be783346e4de9f5b0fa5d,,[2447],1,0,1,0,[]
0xff351b7ea7c175ac68af8d55d83f2237eb865920,,[2464],1,0,1,0,[]
0x00c97692ad66c21d683ca888f40442b5559f20a8,,[2465],1,0,1,0,[]
0x0a9a7513f160ee78cee87942239b81d08ac86aeb,,"[2468, 2469]",2,0,2,0,[]
0x927128dd95bee9e3178683147978d23c59134284,,[2470],1,0,1,0,[]
0x70aef3df1f89334aec7cef666162b0db2c9bb334,,[2471],1,0,1,0,[]
0xaa8e3fce3c1aa0a1aefdb00c2bb539eee090e7bd,,[2474],1,0,1,0,[]
0xe6810a6875eb3b432a8e0c6e405b42ec2aa47b14,,[2475],1,0,1,0,[]
0x9c73c4aad98146564f48be1553c9330cb0bdab71,,"[2486, 2487]",2,0,2,0,[]
0x5ed5aff8cfd2d26e25716e0227c052564dd94eaf,,[2488],1,0,1,0,[]
0xba7d40b90c84e199567e73d00dfbd01a7de4b463,,[2502],1,0,1,0,[]
0xa48a4a3d159998530ea7df55c9ff0443719bc370,,[2179],1,0,1,0,[]
0xfbea552e3e68d7cdbccb93a761571ff15550824f,,"[2565, 2566, 2567, 3321, 3322]",5,0,5,0,[]
0x6fcc02c3fd00d9e90295f4b0e60562fc2bba6a0d,,[2569],1,0,1,0,[]
0xa2c434f6a06d59f8d4584f82ae39219dc74cdb5f,,"[2571, 2634]",2,0,2,0,[]
0x76a95d549ca36d955df2c72f693690d8e51a94d0,,"[2573, 2574]",2,0,2,0,[]
0x0b83c462b723e90b25592ab2eecbb1dd875829d6,,"[2577, 2578, 2579]",3,0,3,0,[]
0x67bb28b85ff97a77d9160d94642a0989a7c76ed5,,[2580],1,0,1,0,[]
0xf8e2354363298119ae61243224a6c0518d206551,,"[2584, 3408]",2,0,2,0,[]
0xdaa7eebe022e138483efadae3cae4516399be020,,[2585],1,0,1,0,[]
0xc5d35efb42d88b46983b08f844eb304edaaf2806,,"[2595, 2596, 2863]",3,0,3,0,[]
0x5ed1cf09c99ababe7a004afc76f2a85008f2d821,,[2602],1,0,1,0,[]
0x8ccc87d4c25e539bfeb386980836e7dad31016c6,,"[2603, 2611, 2605]",3,0,3,0,[]
0xb0c54428faf41e7db8db51abef6ec1296442c45f,,[2613],1,0,1,0,[]
0xd18cae2ec8ece1b63c4120635a0bd6dc90683757,,"[2614, 2615, 2616, 2617, 2618, 2619, 2620, 2621, 2622, 2623, 2624, 2625, 2626, 2627, 2628, 2658, 2657, 2656, 2655, 2654, 2633, 2632, 2631, 2630, 2629]",25,0,25,0,[]
0x7a23f40d9b58e3bdbb3e04f8270610dffc8ca08a,,"[2637, 2638, 2639, 2640, 2641, 2642, 2643, 2644, 2645, 2646, 2647, 2648, 2649, 2650, 2651, 2652, 2653]",17,0,17,0,[]
0x958fb46a7160b1cdeb6b3fa852841d03ca51d2e3,,"[2659, 2660, 2661, 2662, 2663, 2697, 2699, 2700, 2698, 2701]",10,0,10,0,[]
0x7d7ee539617ba9b5b011a7b41919954066437fbd,,"[2664, 2665, 2666, 2667, 2668, 2669, 2670, 2671, 2672, 2673]",10,0,10,0,[]
0x19d7cf9434d88c760e0306a02cda842d6a147679,,"[2676, 2677]",2,0,2,0,[]
0x7afa407ada77c9d9c7f68fadb0310653f7e402e8,,[2682],1,0,1,0,[]
0x0fe7e0f4923ee18333c3c1fa65d847839e7ae88c,,[2703],1,0,1,0,[]
0xe8459d8878daa4eeee1fc006af55575cf68ea3cb,,[2711],1,0,1,0,[]
0x6e709dae37d8ec9567c72151406886f966d4cb32,,"[2777, 2778, 2779, 1692]",4,0,4,0,[]
0x9ff26986426546f5c0a722331f9b980747e3f661,,[2780],1,0,1,0,[]
0x848b4c1e80627d472f5c6aa3fed13c97bbc435f0,,"[2787, 2789, 2793, 2797, 2798, 2872]",6,0,6,0,[]
0x6633ca9079c2a6e01f0a8de2239795b7922d2ccb,,[2788],1,0,1,0,[]
0xc78698959bffa8e4a99ea0adc2ea587a97d3e412,,"[2857, 2858, 2859]",3,0,3,0,[]
0x976a1bf8e2475b18c1ba58efff7f1b1c74e73a8f,,[2871],1,0,1,0,[]
0xdc120446b200d1b14fcf8f81016c04a486ef8fb7,,[2873],1,0,1,0,[]
0xfa3ea70742595e445c5152d5ddecac2ec32721ee,,"[2890, 2891, 2892]",3,0,3,0,[]
0xae92841d024ac8c74ffcc256d617c93fa2efc245,,"[2896, 2897, 2898]",3,0,3,0,[]
0xf28c9ddf89d3c0823911c5b7501ad195072395a3,,"[1699, 2899, 2900, 2901]",4,0,4,0,[]
0x6089c5aa293fd899e24c6f52ae47f4d31e5250a1,,[2902],1,0,1,0,[]
0xe6a53b80dfa693626ab377f7962d8d8fe3869565,,"[2906, 2918, 2919, 2923, 2945]",5,0,5,0,[]
0xea1080d099bac7106067d9f8f3d8d97b2018d1d1,,[2924],1,0,1,0,[]
0x0184147d4fd0e07c88c6a94c0c73395ad9bff408,,[2925],1,0,1,0,[]
0xfa2c8eac905b4fcde98f8ab8907a1fed8a516b41,,[2940],1,0,1,0,[]
0x515afd2d9ba6ffe2697778d64f1f1520f20f11c8,,[2941],1,0,1,0,[]
0xa65f981a8861d9333844702c554ddbcef6b02b36,,"[2211, 2212]",2,0,2,0,[]
0x510c61c8313cda928d50c6337dfa216929d7c5a8,,[2998],1,0,1,0,[]
0x172742d87809338cc9f409adb48322ca2eceaf3e,,[3009],1,0,1,0,[]
0xe55f3aacbf4d2f255afbec97566e1974e8d6da4a,,[3022],1,0,1,0,[]
0x3ffae0ade26f281a32d8d18b937b6daf3e4a3e8e,,[3028],1,0,1,0,[]
0x85203dfe4a32494accb16e197015aab4681a33e4,,[3034],1,0,1,0,[]
0xc392833f3fd2ee6ef9219958791d04e377fdaea8,,[3035],1,0,1,0,[]
0x43d1f14c7d6bbe245ad4a64904f9e485e6114f4a,,[3055],1,0,1,0,[]
0x3154677b603c2b30810b46a56b46892aa09d60e2,,"[3056, 3057, 3058, 3059, 3061, 3062, 3063, 3064, 3065, 3299, 3301]",11,0,11,0,[]
0xa190d2b7990e91c83838de0e038f04f11cf12639,,"[3077, 3078]",2,0,2,0,[]
0x40cbae3e281b190db845f20655d7ffbad0ba72e3,,[3080],1,0,1,0,[]
0x44eca7976283dbf01522aef424a9fbcedcfd1615,,[3081],1,0,1,0,[]
0x48b1d5e4c7a7319ad85a53b637946558ab17251c,,[3082],1,0,1,0,[]
0x09a0b76ede80debc3a470965a2e38d2d7fe3c2c2,,"[3083, 3084]",2,0,2,0,[]
0x917d3811cbaf0ee55b96f2ae9c020bff834aa46c,,[3085],1,0,1,0,[]
0xe3ea37edeaa93d4e34281eda3850f5634f46b236,,[3087],1,0,1,0,[]
0xdc4fd106500e9c2f2e6c56c0d1c61d0c31c3dbfa,,[1769],1,0,1,0,[]
0xf43fb253bee0c814a5d27d1e3e96764f21b18117,,[3095],1,0,1,0,[]
0xb9df186357348e727e023d1373a1bb4cff5c1601,,[3096],1,0,1,0,[]
0x881e4a56d0a987e588d6a7b4d7a782df39b6a9c6,,"[3099, 3100, 3101]",3,0,3,0,[]
0xe73bbce7efa7e202236538528c4b9975e1d12deb,,"[3102, 362]",2,0,2,0,[]
0x5eb6e15675e60476f7be629070251be272418d60,,"[3103, 3104, 3105, 3106, 3107, 3108, 3109, 3110, 3111, 3112, 3113, 3114, 3115, 3116, 3117, 3118, 3119, 3120, 3121, 3122, 3123, 3124, 3125, 3126, 3127, 3128, 3129, 3130, 3131, 3132, 3133, 3134, 3135, 3136, 3137, 3138, 3139, 3140, 3141, 3142, 3143, 3144, 3145, 3146, 3147, 3148, 3149, 3150, 3151, 3152, 3153, 3154, 3155, 3156, 3157, 3158, 3159, 3160, 3161, 3162, 3163, 3164, 3165, 3166, 3167]",65,0,65,0,[]
0x4c3ac029f3a2dffdbfb613149c614687dbe308a7,,[3185],1,0,1,0,[]
0x7abcbfb986bfca6714c49f46dc108f55f453600f,,"[3198, 3199, 3200, 3201]",4,0,4,0,[]
0x5ee9f738d07cec3f55ee25de9fc2386a16abede4,,[3202],1,0,1,0,[]
0x5bca4075dfc8065235cf75c6b15b410e62845fec,,[3203],1,0,1,0,[]
0x0c7e4a4a344a5da4e785cf42db33e88d4ff238dd,,[3205],1,0,1,0,[]
0xfc3b47508fc5ec1b4c4d355fa845388ecfb4eb91,,"[3206, 3207, 3208]",3,0,3,0,[]
0xec4ae79070be5b5e86f4ad766995fb234c90735e,,[3209],1,0,1,0,[]
0x150f483ba3f5e7127a845465c9221770f91b2121,,"[3210, 3211, 3212, 3213, 3214, 3215]",6,0,6,0,[]
0x1c9af6ab47987c9fb7f6ce3baa8c64e50b721eb1,,[3216],1,0,1,0,[]
0xc495b5b9568e48ac5ffb8214222ad241bd527e2d,,[3225],1,0,1,0,[]
0x1bc09946b7c42a61617f64c2e1e0dc7ed9cf6167,,"[3226, 3227, 3228, 3229, 3230]",5,0,5,0,[]
0x0b4f2b00607e1162bf232c6b8e3e6e0405d46ff3,,[3231],1,0,1,0,[]
0xc6e73dd058d6ff3105e9c7b71262343898011378,,[3232],1,0,1,0,[]
0xb0e7884966231e0dd96bac6c11b7be1467b09e3e,,[3233],1,0,1,0,[]
0x8d038707d9623ba759f59933b7234e4882eda212,,[3239],1,0,1,0,[]
0x19200af6ddb1e1338a1a3b5ea191acdccfe26546,,[3254],1,0,1,0,[]
0xe58bedbbb296f5a7c8ed1c2177ed0b28274c3942,,"[3255, 3256, 3257, 3258, 3259]",5,0,5,0,[]
0xd635ebd77746c5df27213902c266596ab23d4715,,"[3260, 3261]",2,0,2,0,[]
0x0b1be579fe6f1d6a8c4514052d5036f1ee8d8fcb,,[3283],1,0,1,0,[]
0x26d515cc40f617cdf77db958783480e5a3d95434,,[3285],1,0,1,0,[]
0xbbe02c19c85716a12ae05f57b17664d4ff9e9de6,,"[3286, 3287, 3288, 3289]",4,0,4,0,[]
0x3d9ea5ccf48f4454d2e29c924e2780fec5923e4e,,[3290],1,0,1,0,[]
0xc2eaa5870c31ffc069238a3c73c79bd29826e299,,"[3292, 3293]",2,0,2,0,[]
0x432c7faebf7573fefc50c1eedc46723c31d2154a,,[3294],1,0,1,0,[]
0xb91a23971cabce0db9dbde18f554e47f8ff6f9f3,,"[3184, 3182]",2,0,2,0,[]
0x93f7af2f3fe6695f8da42a4282b0c96f316cbf28,,"[3314, 3315, 3316]",3,0,3,0,[]
0x4c66c7e4b59a6287c71e2b18b8f5587f1f9197ad,,[3320],1,0,1,0,[]
0xd7171f33dad845275895c8bd18078e3df364ac04,,"[3333, 3334, 3335, 3336]",4,0,4,0,[]
0x70f2d537e084319c0a6c98c107bc50c1f980caa4,,[3337],1,0,1,0,[]
0x3c7b781c4fd9b53d5cdd0984b4cf2d3ed943a25a,,"[3342, 3343, 3344, 3345, 3346, 3347, 3348, 3349, 3350, 3351]",10,0,10,0,[]
0x6db18767620d07d1892ba3958fb1d97fd918fcf9,,"[3357, 3358, 3359]",3,0,3,0,[]
0x6ab8db6f63760ce69ee31e5c188ead5890b95e94,,"[3363, 3364]",2,0,2,0,[]
0x24bbe22930961dc2bab6c06b6fb85e430475b09b,,"[3367, 3368, 3369, 3370, 3371, 3372, 3373, 3374, 3375, 3376, 3377, 3378, 3379, 3380, 3381, 3382, 3383, 3384, 3385, 3386, 3387, 3388]",22,0,22,0,[]
0xd0b8f03f66698310255534587fe79d8334f19724,,[3393],1,0,1,0,[]
0x516ca91e70f06f3da0746b3800e626440500a2a9,,"[3406, 3407]",2,0,2,0,[]
0x595b581e78f973a5daefc8563b9eb3930e91ac5c,,"[3397, 2927, 2976, 2921, 2922, 2920, 3401, 3394]",8,0,8,0,[]
0xb4e97304da28e3789c722a876b3d258f815007d9,,[746],1,0,1,0,[]
0xd50d3ee908594bad12a7519999172811e37aadc7,,"[735, 737, 736, 734, 2002, 12]",6,0,6,0,[]
0x313850f77cfffb0c7743c0d2e6c3bb301c4a221b,,[1695],1,0,1,0,[]
0xf15034485c73c40fa7fe79d4a631cb348a095362,,[1085],1,0,1,0,[]
0xf4f891a3ed1253d7bfd9876f497faf1c9380dd25,,[507],1,0,1,0,[]
0xe465cc5f03b9e9395cbf5fa07f14255141388d82,,[726],1,0,1,0,[]
0x7ea30c24fd2c5e2654c81cb299612493777a6710,,[1750],1,0,1,0,[]
0x2a462eb09f4e101862d16d0098b5077eef0b76ec,,[3284],1,0,1,0,[]
0x11047ba5c5fe45e24fa78639e31acca9c9d26447,,"[2491, 420]",2,0,2,0,[]
0x371cd6ac571431e49689e62f891dc0d23bd0f75c,,[3252],1,0,1,0,[]
0xe508a1b3b8b4b7a49e0cb667697891845311dedc,,"[2875, 2874]",2,0,2,0,[]
0x0a76785d5e0d557d32b3941c65c45339eb790da8,,[506],1,0,1,0,[]
0x4f537b48d733ebe10acd44de03d8caca1b0341ab,,"[3253, 1097, 842, 770]",4,0,4,0,[]
0xd67a9bc98e0c459267eb5b4390a28c75f041154b,,"[1234, 1239, 1238, 1233, 1232, 1236, 1235, 1237]",8,0,8,0,[]
0xc8b602c314efcf389263bc35cc7a3a5a0af0d2db,,[3170],1,0,1,0,[]
0xa2a923954ddeeff6a0bbeb88eb2233eb8eda63a0,,"[1704, 1706, 1690, 1684, 1694]",5,0,5,0,[]
0xbae7656b4e3f6c634b6426d420ea0d6322bcbdc3,,"[2704, 2705, 2706]",3,0,3,0,[]
0x191422b6d1eafcceaa0b00adabcd7f99d759344e,,[3093],1,0,1,0,[]
0xdfecb1b3388b054b2fca156697f2c4f699df37b3,,"[3168, 3169]",2,0,2,0,[]
0x89998ecbd4aeb30800b6ec2735bcb5648a3f6192,,[3204],1,0,1,0,[]
0x2227525a2818ebb647efeedc0680acc772a0c28c,,"[3172, 3179, 2399, 2397, 3174, 3175, 3177, 3173, 3180, 1254, 2398, 2401, 1241, 3181, 3176, 1253, 2400, 3178, 1255, 1256]",20,0,20,0,[]
0xe9b5520ccd92e6b44a3d9b7715e6a52f8269518b,,[1865],1,0,1,0,[]
0x548e52b599ab68cf507764f414a1eccf6912db66,,[2562],1,0,1,0,[]
0x3553517decfa7447086a11308e3b49795779162e,,[1323],1,0,1,0,[]
0x2ee108ddc4c864b47d12895a1a86500c4d42baf6,,[508],1,0,1,0,[]
0xb884f20072781701d21cb30829c44476e8c8cf10,,[857],1,0,1,0,[]
0x7abb7ea4728af65e38fdd5784c8a8edd4f3f01b1,,"[821, 653]",2,0,2,0,[]
0xab91d85db1ca6ca2c5e58181eb557334e04bc34a,,[2467],1,0,1,0,[]
0xa63caf95ad457eb70146f53fee965bf0f8c34f79,,"[477, 484, 471, 486, 481, 472, 474, 473, 475, 476, 480, 478, 479, 482, 483, 485, 488, 487, 489, 490]",20,0,20,0,[]
0x822eae753f03be87b41382e1b429e22a99a43330,,[910],1,0,1,0,[]
0x31b4f6f0f3d6682631952fe1d012ebe4dfa2ab72,,[3044],1,0,1,0,[]
0xe6ea3dd816eea2c6d0de2cd7e7288e438e09d770,,[3045],1,0,1,0,[]
0x41f54801bfaca3c2aa1090dffcade3abeaabcab7,,[3040],1,0,1,0,[]
0x9c5032858b995ebb974e7c1fed167cb93b61fb57,,[351],1,0,1,0,[]
0x2ddc842ce54866d6ff58f5f82c6fb838e6a74cd3,,[345],1,0,1,0,[]
0xe1793bf61117a4e7a9cf8605cda750c64303e3df,,[347],1,0,1,0,[]
0x8a7c9f55cb51aea0261adcb751d17b3b443f3e2b,,"[359, 2973]",2,0,2,0,[]
0xed609053d20c480bfb62c650ea769dbb5e9d00db,,[361],1,0,1,0,[]
0x1c32b1ccf751b64ec4e9cb34a52b6aa97183ac96,,[1693],1,0,1,0,[]
0x5d149d2b5694055bd79f061a7d5ac53ec604ec9d,,[357],1,0,1,0,[]
0x9e0f1fdb6a630a6e2fbe44a2d62696c10087412f,,"[540, 539, 517]",3,0,3,0,[]
0x47d2d609e86438da73f0183c0f5ca6b13986bd71,,[2970],1,0,1,0,[]
0xcd75c47b2ec49e92cc673269b53d1a75d023dfc9,,[2862],1,0,1,0,[]
0x9418f68ac120925b3ab0d68865ecdb37dfe57fe8,,[1881],1,0,1,0,[]
0xcb388ee4d518ec710c8b101f85ac9a9c3c197ae8,,"[1553, 2969, 3038, 3365, 1534, 500, 914, 2790, 2968]",9,0,9,0,[]
0x906f6e7a268369d9d4fd083a8c73bb3201c306b6,,[1003],1,0,1,0,[]
0x187923d900439d60485b7768d3c6630895fd723c,,"[2860, 184, 215, 849]",4,0,4,0,[]
0x434241be641f24ed1d7ea1d0fa349c0b9f0a38e2,,[397],1,0,1,0,[]
0x194993a537faa14bf31e19fb32f275b2113f9df0,,[1764],1,0,1,0,[]
0x4b726e805634a70f61c828b2bcfb459ac60befe5,,[1436],1,0,1,0,[]
0x354ab983a985c5bb8d44517243771846d127e7d3,,[1134],1,0,1,0,[]
0xc4919684dfb694fb8452ad2fd6b98f1da5ffe92a,,"[2753, 1099]",2,0,2,0,[]
0xb1bbd152e22752f54df8dbad4af79eacbec7266b,,[2020],1,0,1,0,[]
0x78263c287f840f6ed12c7d779591a90b5619a009,,[2916],1,0,1,0,[]
0x6df137e629792df6a1d728cb9069389ef2f63587,,[733],1,0,1,0,[]
0x29db3d715bffd0b50862de8635186c5ac02c0831,,[652],1,0,1,0,[]
0x981d81b6330726fc9a6c0efbd7827e8d591967cc,,[981],1,0,1,0,[]
0xd94256e9119989a4fbec475fe25d6e7603c40fe0,,[1145],1,0,1,0,[]
0xa0ac849cd3e81b276012ac1d9f85c33f38768d1d,,[436],1,0,1,0,[]
0x42c5d633ac3486115db8f5a23f7dbd4b0d259cc4,,[1150],1,0,1,0,[]
0x8b8d8973ee869ab60af73534d389485c4806529d,,[2932],1,0,1,0,[]
0x09a84adf034e5901b80e68508e4fdc7931d9a7c9,,[1149],1,0,1,0,[]
0xd59303ef46c98f3c106656603c291930a0ef4b99,,[1148],1,0,1,0,[]
0xc42d07040365ebde8edb46fff6627f354b82f70a,,"[1603, 1359]",2,0,2,0,[]
0x31f289c19e6ad5cc63b84191697cbf10fe5cece4,,[729],1,0,1,0,[]
0xef673c427abdff80481af4ce15c42f0879c34708,,[763],1,0,1,0,[]
0x714953ee81a9e36415b704ee690612bf52f6a8f5,,[982],1,0,1,0,[]
0x7dd2a4c84b881ac5fba89bb29518766116140272,,[1221],1,0,1,0,[]
0xbc903892e4fa01291802e6b5328905e939e08a10,,"[1666, 2935, 1643, 1358, 1357]",5,0,5,0,[]
0x874eeb07c8c90f9751b04cafa1126c45b0e53e63,,"[1710, 1707]",2,0,2,0,[]
0xa7fe905ce99a839c7fccba0ac4c71bc4824871d9,,[1366],1,0,1,0,[]
0x5fb8428bd74a9064422092cf9bac9962f45de0fa,,[708],1,0,1,0,[]
0x455a71d29c7514dda3ed7e097668d709e84d408d,,"[1183, 1674]",2,0,2,0,[]
0x7c819580eb42988aaa1aeeaf8f01b676af7f03f0,,[1354],1,0,1,0,[]
0x5050b4804755423106586b7c8b461031e9731a1f,,[1683],1,0,1,0,[]
0xe55460491a8a1f836df8d244724db80a97ae0dd2,,[1348],1,0,1,0,[]
0xdc5928f14ca3288b8a93be4efafe1d58d9ac413f,,[1353],1,0,1,0,[]
0x11f5776bacfdd43f53f2bfc1081b1e6496795063,,[1682],1,0,1,0,[]
0x55b095a39cad1dc95691bbe17c8cc270fb6d8ca8,,[3395],1,0,1,0,[]
0xe1a647292a7d06ba2161768b53d66d88804479d6,,"[1058, 1096]",2,0,2,0,[]
0x87d2aa6539d4bed79ccd87c55bcb6aac0f7e07b0,,[1891],1,0,1,0,[]
0x2462d4bb61558e1dfe0fcbf819552debb1aee22f,,"[1330, 1329]",2,0,2,0,[]
0xfa21595b6a86352a6250509ffd87c10ded4a36a3,,[3060],1,0,1,0,[]
0x035ebd096afa6b98372494c7f08f3402324117d3,,[1802],1,0,1,0,[]
0x3aff589875080e8ca02c3d7b972e6517978cd594,,"[1381, 1687]",2,0,2,0,[]
0xd1022b0ffbb0e2585387a7be3fe6126c6b613db5,,"[1385, 1379]",2,0,2,0,[]
0x469727debd453bc7e58ac47a33018b5041ecbd47,,"[1382, 1312]",2,0,2,0,[]
0xa1610b728ad33fa248aacfc6cbdd2fb8b7244dc4,,[1311],1,0,1,0,[]
0xea206e2bb49c346f41f62f7f8afd31a97f0019c4,,[1711],1,0,1,0,[]
0x395157a981c2f91920b259454b7d80dde33a4b08,,[1308],1,0,1,0,[]
0x5505f7442fcbad24f65265c422f8a055993815c4,,[1307],1,0,1,0,[]
0x2dcda1defdf3c64285a6b35dfe5cd4198fc6259e,,[3399],1,0,1,0,[]
0xbd19c3b6b2882e788d09e238908a30fad9d2b803,,[1364],1,0,1,0,[]
0xd39625e19dc470f6b976c6cf1eb5cb6ea7672af5,,[1363],1,0,1,0,[]
0x6f87015922908aec7bdb997af0b007c9c43eaa03,,[1361],1,0,1,0,[]
0xf2cb78a3300a5938223e9ea9204d70c6e2a595f7,,[1389],1,0,1,0,[]
0xfb3e94d707f8cbfd9a36e8d4db929e34d4c0e9d0,,[2061],1,0,1,0,[]
0x844f3e3e12256dd44df59631bf3fe7fbbb2f5232,,[1371],1,0,1,0,[]
0x12b98424d06f88a1454a0b1487c8b43a0338179a,,[1375],1,0,1,0,[]
0xf4577a54e6b01d21552b98c66053c9d5f7899468,,[1374],1,0,1,0,[]
0x3309e3e19c45e16a73d86ee7052be066cbe70502,,[1373],1,0,1,0,[]
0x587de1d81441adeed1bd56dd8b8d3ee589045fd1,,[1372],1,0,1,0,[]
0x9a875f6ce282e8009aa9432784f8124067032c99,,[1063],1,0,1,0,[]
0xc54b7adeab3e952df25c798f4b8cdd76f45992f4,,[2065],1,0,1,0,[]
0xda328d1f9bf23e7677941c9acf50b09dfb0392d3,,[510],1,0,1,0,[]
0xb41ff41f0c767ac8628a4a2093e9e8e5326b68eb,,[1133],1,0,1,0,[]
0x7b177851351487a28582e20163054ddcfcc460ff,,[200],1,0,1,0,[]
0x2107735355c48d6ee1ae668b6a659b11dd5e62e3,,[978],1,0,1,0,[]
0xe473135d12e4bbc79dd6bb66ec97d7abc1842f48,,[276],1,0,1,0,[]
0x8dea1a7895058e796c6b5dda710d446aaf1ebb59,,[549],1,0,1,0,[]
0x80a7747adadd60de888da9d7e9054e8d33817d02,,"[1896, 509]",2,0,2,0,[]
0x9e2704299f3d88cb2f582298f14ebe623c3b3c6f,,[390],1,0,1,0,[]
0x80654713bd90ae5150522ff140dc9cfb025da373,,[1686],1,0,1,0,[]
0x0c5f968bde6f5f01112486bdacd29d6e87ca1168,,[2570],1,0,1,0,[]
0x8b05bae4882907465e1ea6452e18f54df16243e5,,[1143],1,0,1,0,[]
0xd0105e60b97c9114fc65e7c6d852744e40b46939,,[1668],1,0,1,0,[]
0x21516572cf3c12054f9e612788b20bea1a6bfa0a,,[1691],1,0,1,0,[]
0x5b949ccd250d1cef9c30b754dd712b1f64000805,,[494],1,0,1,0,[]
0x337356cd1b4016b5f76fc6e2d38a3f91a6590fbd,,"[2072, 287]",2,0,2,0,[]
0xc42fd68e2d39a633652a346fa5e26e6b03171382,,[1681],1,0,1,0,[]
0x8556cd797078aa7d2dfaf95f6be2b75c219edfb0,,[1360],1,0,1,0,[]
0xb190d365784d7b7decda84f44d58ceb22affc177,,"[1141, 1135]",2,0,2,0,[]
0x0d99d9c32d012620ee07dbf0b7a020a633c4fbcd,,[2594],1,0,1,0,[]
0x751653498c0ccb8a29902616d7c3e81dd7430824,,[492],1,0,1,0,[]
0xabca32e79bb2e2d46115ae2360ca6ade95d82ee2,,[491],1,0,1,0,[]
0x5d1e8c0a84e48b5e9050cee8e07b711e7510ab5f,,[1675],1,0,1,0,[]
0x8b69aa59e7c33315fb633c963cb5f25a1fad7825,,[1671],1,0,1,0,[]
0xfa2a56aef60425e1391cfbaf1dd245e95ad72ff9,,[1677],1,0,1,0,[]
0x0bb98a5d04e972db9ded869e0e398cea9e65be49,,[1678],1,0,1,0,[]
0xe96a62b752f988d591bcf2f863340ca7011f2886,,[2775],1,0,1,0,[]
0x321d67055b9da7dfe6c48299e4c9a744c0b8ad78,,"[1488, 516, 2895]",3,0,3,0,[]
0xda0aa8ef337d141d0739b965b3eddda252972226,,[1146],1,0,1,0,[]
0xc39268a008f8075f45d69cf64e90458fcb474326,,[2568],1,0,1,0,[]
0xc6b7f143b37ca7efe4f1f3c6bdfe3fb759e16000,,"[3037, 2129]",2,0,2,0,[]
0xdfacb9511e34ce1c1f68d32b830553467d2b078e,,[2572],1,0,1,0,[]
0xc357a84a334b5c5cc21b962fef583c448f74a2df,,[1615],1,0,1,0,[]
0xdfd0855c31ceeaaabb8ba878b76cf3ac54418001,,[2234],1,0,1,0,[]
0x51a04469849acc3ee53c93a6b48ee7c962b4275f,,"[3390, 1511]",2,0,2,0,[]
0xb86a54728d486292c4acc76533fd703428f38669,,[1816],1,0,1,0,[]
0xd45f2708c7585023f213369ebeb9b55a37c88854,,[1815],1,0,1,0,[]
0x693beed7d2fa848af35e15775a0f73330cf7cbb9,,[1098],1,0,1,0,[]
0x4138da2c1f1c48d2db340c314523de5d3c1f20db,,"[3094, 1810]",2,0,2,0,[]
0x9f943a8687e0249db242e1e87bccc0ec7a6b667f,,[522],1,0,1,0,[]
0xe74b29860eac6b1e240229affba575be1cf206c4,,[1278],1,0,1,0,[]
0x74895da3ef09a24ff6ba35d241f3a860e8637c55,,[3366],1,0,1,0,[]
0x0a224d67f1758aa6fb738228485120b659f36957,,[538],1,0,1,0,[]
0xb80490a52ce66182d5f7d3f32d4d493066228237,,[544],1,0,1,0,[]
0xbfbe795e1ef4d9dfbdc604db53c20932a88bd490,,[1575],1,0,1,0,[]
0xecacd3ef02f3d9dc3c8f5048169211c2a90bd6f4,,"[955, 954]",2,0,2,0,[]
0x95d7be02646cf85e1cb7a0b645e8961264dc8279,,[2930],1,0,1,0,[]
0x8b851ef265bb2a3e4f5e0180913602cfa75641f5,,[1288],1,0,1,0,[]
0xea0d3d48e8e4e99364a2e5615b5937a91a5ff328,,[183],1,0,1,0,[]
0xea3a3b8577fb34065e2df0c1216f8e2d5ee78c83,,[2132],1,0,1,0,[]
0x710d712de1393708051b31c18d84bb7b71b3d4ae,,[1667],1,0,1,0,[]
0x5775da646cd1f036485b2cf683e942d2f48e141c,,[187],1,0,1,0,[]
0x0a8821b052c6a153b0614fd0860f49d742e6bf88,,[2745],1,0,1,0,[]
0xb2a4d885ee0e4b2418d6a7736f8c4bf6c4291f5a,,[586],1,0,1,0,[]
0xd3558839869e7185c07cb7f854df8f6933236af6,,[550],1,0,1,0,[]
0x966df08d720bfa46afc7ec8ce807b16c89d66343,,[2131],1,0,1,0,[]
0xaa3c97470f97c1cfb34d93b1e0dcea14b7d4622e,,[552],1,0,1,0,[]
0x185999b6c642a369cb019fafde81186c5cf212a4,,[133],1,0,1,0,[]
0x1ca13d6342c834c197cc111d6247607a044a2083,,[132],1,0,1,0,[]
0x39e0d8dd286adbc4224a2d597a02b5ce7c619324,,[3398],1,0,1,0,[]
0xf94abe8ecb988ecb9e5471db3608056d8d500360,,[559],1,0,1,0,[]
0x369dfe5197d1acb83ff8ec498f1436b53d2981fb,,[117],1,0,1,0,[]
0xd0551e7871e3d45abdc56400a7595bd059151daf,,[221],1,0,1,0,[]
0x2dd0919d8667c90ec8dffbb06a7e77c6f235f421,,[523],1,0,1,0,[]
0x360a105578ef25c0756428a1bfef365773f1e0f2,,[353],1,0,1,0,[]
0xe1f72d3870f5e8022ffe0a7d5227ecbe9fc26920,,[220],1,0,1,0,[]
0x1664be58c98fa0d24b31efec94cb76136db8c627,,[1761],1,0,1,0,[]
0xf638076b4d6cc59df14bb5e78cd04a69effabb38,,[126],1,0,1,0,[]
0xeafdd624d9953aaad9b5cae41bf78f44afaa5b47,,[2926],1,0,1,0,[]
0x0348817c8285c282cf4918513b5a0284a456bb0f,,[633],1,0,1,0,[]
0x0aa5141fb867b616b9584492698330d3dbce1180,,[129],1,0,1,0,[]
0xd8b61e38a8ec332efb36257dae8485ff05112059,,[495],1,0,1,0,[]
0xbc5e22502713ab4c5deb3b9e0ab81b9cdeea3ed8,,[127],1,0,1,0,[]
0x8be7f827f8bfa32d47186a07548a4d63c88559ba,,[128],1,0,1,0,[]
0x6bcf5c83bc728c7e7a446bcb5676c4cb41639ea4,,[185],1,0,1,0,[]
0xad80a9fe83e1d1bdd49c4416372b7f1e27ff41c7,,[120],1,0,1,0,[]
0xf155f5a75ff2bccbe2ac3fa20e9e77548516cea0,,[125],1,0,1,0,[]
0xacb997591296c3f78d119bfc83b25d713ccac703,,[1155],1,0,1,0,[]
0x2c237a698a5d0685137ccee28d3624981ebfb012,,[427],1,0,1,0,[]
0x01e416eb124e02b10902f760aa2abf5f1da4b7a9,,[123],1,0,1,0,[]
0x45da8abfa7c64477ce0fd502619769e131d83155,,[121],1,0,1,0,[]
0x41ff8cc5fcb1c2df548089a2c7d3fad5f21ddc84,,"[2786, 2785, 2784, 2783, 2782, 2781]",6,0,6,0,[]
0x25f07885cf7d727b95fc97619a759b36d8497cdf,,[1542],1,0,1,0,[]
0x9fd4e478b058389138a8b2479c9d7fb57c317563,,[1541],1,0,1,0,[]
0xb62ad4841d7bec0bba931e7909fcb26bb0049434,,[1546],1,0,1,0,[]
0xd82ced87a3fbc3d86793de2473d2dd19bec8c75b,,[2158],1,0,1,0,[]
0xbac5b4d871498704116391f7610b29842e7b8fd8,,[2154],1,0,1,0,[]
0x3b341f833a60c0e5a559a3abedbc13c753b8aca5,,[2610],1,0,1,0,[]
0xb79252042f6639d02025ec881d52434cbe8cfb70,,[168],1,0,1,0,[]
0x0a59c47a89e146eaa49c57e86363ab801b4d53da,,[859],1,0,1,0,[]
0x006475c10dac0b7c140351c2791cc55dcb29aa76,,[2527],1,0,1,0,[]
0x74c3503ec66ebfff23cbbfb1d5c675339188d260,,[3222],1,0,1,0,[]
0x8ace749eca4f9bbb03f59317840d228a5ba11520,,[2869],1,0,1,0,[]
0x15a740b85d7c28f9c495ec5dc7b7450aa7e465e6,,[1269],1,0,1,0,[]
0x337587edecba3406578b0756f35210ce06e6a46e,,[2019],1,0,1,0,[]
0x9950f18ed827b070922840a35a1810c6f9a8bcc0,,[186],1,0,1,0,[]
0x4334c8dbe061415623c719d9bc73e13c2d97c4c9,,[1009],1,0,1,0,[]
0xabaea8cc78d2b666288c4b30a61fd185d178c907,,[979],1,0,1,0,[]
0x62675a226443ffb6490ad0ba2447a2a2bec1fc0c,,"[2868, 2601, 2599]",3,0,3,0,[]
0xa6f6982ac519c9ca6c10d999d5915d9925c2eb30,,[2867],1,0,1,0,[]
0x54ae7eb3addbd2ab9e730c8dc02236e2bb6512f3,,[2312],1,0,1,0,[]
0xe9fa69e862089d8ae3b45ca7f9ccd912510bb19f,,[27],1,0,1,0,[]
0xb87782b16f489736c6473212a7926d610343fa19,,[25],1,0,1,0,[]
0xe8691e0b94c29a7e7439d66682129ec3e9e50e56,,[2714],1,0,1,0,[]
0x62a47becc432922f2521398ab584fc3a6ba83648,,[2990],1,0,1,0,[]
0x6b6cced57e0dca05b756355a78c2a60e31a7e421,,[1154],1,0,1,0,[]
0x92192c51d4761c0e8f7445d90195e661fe2f61fc,,[1153],1,0,1,0,[]
0x6f572cefcc54b1036d48220321ef87e0c954c466,,[1147],1,0,1,0,[]
0x1ec0128d5126a61f66a22f261b2656b4f87b759e,,[1291],1,0,1,0,[]
0x562c432e009a645c1751c8ed645ea91baa2ae682,,[1018],1,0,1,0,[]
0x6af243bdc68b6481a7187cec31d4b9b4e4d6006c,,[650],1,0,1,0,[]
0x36a61a984bb0f39fa6867d35f08e85e7195eed1d,,[1290],1,0,1,0,[]
0x3a1e4526ca97ce21b594bca1018b0aa6c413daa3,,[1151],1,0,1,0,[]
0x21d15ba7517c2b11f6aa521ebe01ed0013de1b67,,[2600],1,0,1,0,[]
0x27c7e590bfbd6c5c8b12c60230ed4d8efb438f8e,,[1869],1,0,1,0,[]
0x25b37faee6b1ad39b1f66e638b82a33defd61a80,,[1268],1,0,1,0,[]
0x96eb8d61bca2612f9ebbeb248079caf84e306c09,,[1271],1,0,1,0,[]
0xf441be904cc262c6317ccbdf87a8007dd0d380d5,,[1304],1,0,1,0,[]
0x20dff213b7bc8991fcd9a4c91cc4f8212a6a9aad,,[3400],1,0,1,0,[]
0x1b0c677072c83c664049e9604a71c9db833b38da,,[939],1,0,1,0,[]
0x93399532c40fb8d0d6ab22935778b57f2a4d8b1c,,[980],1,0,1,0,[]
0x2c1a74debc7f797972edbda51554be887594008f,,[2914],1,0,1,0,[]
0x686155de774533477ee1b10361fae15474853959,,[2591],1,0,1,0,[]
0x1e9baf5c20a7a3cc3e55b89ed4e30579e0f072d4,,[2680],1,0,1,0,[]
0x6cf023768b5014683817e751b110044dbd983b3a,,[2961],1,0,1,0,[]
0x856024fef24a02cb0efe4596cc93f7ff2d88caf3,,"[1758, 1698]",2,0,2,0,[]
0xfb1b00cc93092d1f7a9878b79b690e815c40170b,,[558],1,0,1,0,[]
0x7d9ef37a9b68db6cc3febcbe45cd8c9861968705,,[1625],1,0,1,0,[]
0x6d885ae5c1a389beb540f1c21e4e8b9eefdeeddc,,[514],1,0,1,0,[]
0xf11fa82a154d8a4f851ce63412d281d2183e8515,,[1270],1,0,1,0,[]
0xa841b3d156685f5133aac3570f01129cd110ce93,,[3013],1,0,1,0,[]
0x9d964867f10bd102489983a7c4cbff293e8e56af,,[3392],1,0,1,0,[]
0xd940d9a6f3654f35d49d9f1b5213748ef0c4819e,,[1265],1,0,1,0,[]
0x4449494332556d7277395d49f3d8a6841a0c61c2,,[130],1,0,1,0,[]
0xb6f0bc2cd673b34c1be821e54bc21dadf1d60108,,[2763],1,0,1,0,[]
0x274e4af8043600bae5cdf7698192f91448fabad3,,[3300],1,0,1,0,[]
0xefab5c3ae021ae46be027946cebbc1993ad2a47d,,[2598],1,0,1,0,[]
0xea86b3c8415bd5568ac764a8482a16dd7355b0f8,,[1000],1,0,1,0,[]
0x741f07f185d69d8de000eac62f2a1bc5fec898cb,,[1672],1,0,1,0,[]
0x2a6db5db1b5a24e2559cf277dace62a6c638a12e,,[764],1,0,1,0,[]
0x275061413e45008c9d7bd75a2c393711af77a557,,[1351],1,0,1,0,[]
0x4428e5f53677a3a0084803181c2705be509e95f3,,[3328],1,0,1,0,[]
0x01fd5f79305d9239d9aa774b4d554be25714b7ed,,[1350],1,0,1,0,[]
0xec070198c9ace4dfeffed4b6a9308faf5577a329,,[2635],1,0,1,0,[]
0x6ef128dcb630fc2bcd4ab163fa20e7b856bb2aa2,,[2931],1,0,1,0,[]
0xe5eb103e026a37a1eb571fb0b17e9978a6dc8342,,[1419],1,0,1,0,[]
0x7c8b090714142681093615bfbb37d7c0da8a5034,,[1280],1,0,1,0,[]
0x0187c2c7beed7b7ee4682c16cb96e87505625e3e,,[2755],1,0,1,0,[]
0xc95b240139cd3b510c34e3c23abe4661d1d33e21,,[11],1,0,1,0,[]
0x4aa338fbc92a217de6e00aee421bc63094dd2b37,,[1627],1,0,1,0,[]
0x6bfd6274e26cd9cd552de31997fd00ab0e8515a2,,[2764],1,0,1,0,[]
0x85cecd6a0eba2451c206f0e105c169975889efe5,,[1689],1,0,1,0,[]
0x319403467cf64167ba2bfbae806cfe2533fdd0df,,[1264],1,0,1,0,[]
0xbc0b559c7111b5b152aa5473ed5137f4a1e1f572,,[1341],1,0,1,0,[]
0xbc803b3f0b3ae92e10346cfb773b360f2149dd7e,,[521],1,0,1,0,[]
0x089bad4ad54315f062b77ac7e2a8818a49ddd22b,,[280],1,0,1,0,[]
0x2748f6c08cb7257b43a8462fcf78b328f2ca61ad,,[513],1,0,1,0,[]